använder	använder
varningar	varning(ar)
försiktighetsmått	försiktighet|s+mått
cholestagel	cholestagel
används	använd(s)
tandbehandling	tand+behandling
genomgå	genom+gå
tandkirurgi	tand+kirurgi
informera	informera
tandläkare	tand+läkare
lietuva	lietuva
maligniteter	malignitet(er)
kliniska	klinisk(a)
prövningar	prövning(ar)
numerär	numerär
obalans	obalans
cancerfall	cancer+fall
behandlingsgruppen	behandling|s+grupp(en)
jämfört	jämfört
kontrollgruppen	kontroll+grupp(en)
liprolog	liprolog
läkarens	läkare(ns)
anvisningar	anvisning(ar)
tablett	tablett
innehåller	innehåller
vattenfri	vattenfri
eftersom	eftersom
agenerase	agenerase
kapslar	kapslar
vitamin	vitamin
ytterligare	ytterligare
tillskott	tillskott
undvikas	undvikas
hållbarhet	hållbarhet
naglazyme	naglazyme
volymen	volymen
tillsättas	tillsätt(as)
infusionspåsen	infusions+påsen
ampullen	ampull(en)
sprutan	spruta(n)
injicera	injicera
vätskan	vätska(n)
långsamt	långsam(t)
användning	användning
insuman	insuman
infusat	infusat
förvaras	förvara(s)
rumstemperatur	rum|s+temperatur
förhöjda	förhöjda
bilirubinvärden	bilirubin+värd(en)
påvisades	påvisade(s)
patienterna	patient(erna)
tritace	tritace
epoetin	epoetin
kvadratiskt	kvadratisk(t)
rundade	rundade
hävarmen	häv+arm(en)
framåtfälld	framåt+fälld
nålspetsen	nål+spets(en)
studien	studie(n)
minskade	minskade
virushalten	virus+halt(en)
procent	procent
patienter	patienter
crixivan	crixivan
tillsammans	tillsammans
zidovudin	zidovudin
fentanyl	fentanyl
ratiopharm	ratiopharm
särskilt	särskilt
försiktig	försiktig
graviditet	graviditet
beträffande	beträffande
sitaxentannatrium	sitaxentan+natrium
gravida	gravida
kvinnor	kvinnor
innehållsämnet	innehåll|s+ämne(t)
kväveoxid	kväve+oxid
dosmarkering	dos+markering
administrering	administrering
mitotan	mitotan
adrenala	adrenala
metabolismen	metabolismen
kortisol	kortisol
människa	människa
reduktion	reduktion
mätbara	mätbara
hydroxy	hydroxy
kortikosteroider	kortikosteroider
plasmanivån	plasma+nivå(n)
månader	månad(er)
effekterna	effekter(na)
metylnaltrexonbromid	metylnaltrexon+bromid
relistor	relistor
rekommenderas	rekommenderas
burkarna	burkar(na)
tabletter	tablett(er)
produkt	produkt
behandling	behandling
fästingar	fästing(ar)
körförmåga	kör+förmåga
maskiner	maskin(er)
verktyg	verk+tyg
lindrig	lindrig
övergående	övergåend(e)
ömmande	ömmand(e)
förstoring	förstoring
retrofaryngeala	+
mandibulära	mandibulära
lymfkörtlarna	lymfkörtlar(na)
uppträda	uppträda
vaccination	vaccination
möjligt	möjligt
placera	placera
tabletten	tabletten
hundens	hund(ens)
placeras	placera(s)
fuktigt	fuktig(t)
hundgodis	hund+godis
därefter	därefter
ambirix	ambirix
användas	använda(s)
soliris	soliris
koncentrat	koncentrat
infusionsvätska	infusion|s+vätska
lösning	lösning
eculizumab	eculizumab
revaccination	revaccination
upplysningar	upplysningar
läkemedel	läke+medel
erhållas	erhålla(s)
ombudet	ombud(et)
innehavaren	innehavare(n)
godkännandet	god+kännande(t)
försäljning	försäljning
farmakokinetiken	farmako+kinetik(en)
kaletra	kaletra
dagligen	daglig(en)
studerats	studera(ts)
pediatriska	pediatrisk(a)
utgångsdatum	utgång|s+datum
förpackningen	förpackning(en)
randomiserades	randomiserad(es)
trudexa	trudexa
placebo	placebo
varannan	varannan
testförpackningen	test+förpackning(en)
bruten	bruten
förpackning	förpackning
sällsynta	säll+synt(a)
beskrivna	beskrivna
rapporterats	rapportera(ts)
samband	sam+band
olanzapin	olanzapin
exfoliativt	exfoliativ(t)
ekkymos	ekkymos
ansiktssvullnad	ansikt|s+svullnad
baserat	basera(t)
metabolism	metabolism
cellulära	cellulär(a)
lysosomer	lysosom(er)
troligt	trolig(t)
idursulfas	idursulfas
involverat	involvera(t)
cytokrom	cyto+krom
medierade	medierad(e)
interaktioner	interaktion(er)
reducerad	reducerad
viraferonpeg	viraferonpeg
dosering	dosering
kombinationsbehandling	kombination|s+behandling
framställning	fram+ställning
moderlösning	moder+lösning
maximala	maximal(a)
koncentrationen	koncentration(e)n
produkten	produkt(en)
lösningen	lösning(en)
blandas	blanda(s)
minuter	minut(e)r
solostar	solostar
upptäcker	upptäcker
partiklar	partiklar
injektionsvätska	injektion|s+vätska
injektionsflaskor	injektion|s+flask(or)
injektionsflaska	injektion|s+flaska
vätskeansamling	vätske+ansamling
svullnader	svullnad(er)
händerna	händer(na)
vristerna	vrister(na)
fötterna	fötter(na)
hjärtslag	hjärt+slag
hjärtklappning	hjärt+klappning
andningssvårigheter	andning|s+svårigheter
viracept	viracept
obetydliga	obetydlig(a)
effekter	effekt(er)
förmågan	förmåga(n)
framföra	fram+föra
använda	använda
batchnr	batchnr
innebär	innebär
plåster	plåster
timmarsarean	timmar|s+area(n)
plasmaconcentrationen	plasma+concentration(en)
farmacevtska	farmacevtska
mikrokärnstudie	mikro+kärn+studie
reparationsstudie	reparation|s+studie
negativa	negativ(a)
behandlingen	behandling(en)
diskuterat	diskutera(t)
eventuella	eventuell(a)
medicinska	medicinsk(a)
dyslipidemi	dyslipidemi
vetenskapliga	vetenskaplig(a)
slutsatser	slut+sats(er)
vanliga	vanliga
biverkningar	biverkningar
behandlingsutsättning	behandling|s+utsättning
bortezomib	bortezomib
omfattade	omfattade
neuralgi	neuralgi
perifer	perifer
neuropati	neuropati
sensorisk	sensorisk
trombocytopeni	trombocytopeni
ejektionsfraktion	ejektion|s+fraktion
trötthet	trötthet
doribax	doribax
studierna	studier(na)
effekten	effekt(en)
kombinationen	kombination(en)
irbesartan	irbesartan
hydroklortiazid	hydroklortiazid
fertiliteten	fertilitet(en)
utvärderats	utvärderat(s)
djurstudier	djur+studie(r)
irbesartan	irbesartan
rapporter	rapporter
överdosering	överdosering
förekommit	förekommit
rekommenderade	rekommenderad(e)
terapeutiska	terapeutisk(a)
försiktighet	försiktighet
iakttas	iakt+ta(s)
leukocyt	leuko+cyt
neutrofilvärden	neutrofil+värd(en)
orsakar	orsak(ar)
neutropeni	neutropeni
tidigare	tidigar(e)
läkemedelsinducerad	läke+medel|s+inducera(d)
benmärgssuppression	ben+märg|s+suppression
toxicitet	toxicitet
benmärgssuppression	benmärgssuppression
förorsakad	förorsaka(d)
samtidig	sam+tidig
sjukdom	sjukdom
strålterapi	strål+terapi
kemoterapi	kemo+terapi
hypereosinofil	hypereosinofil
myeloproliferativ	myeloproliferativ
deutschland	deutsch+land
janssen	janssen
raiffeisenstr	raiffeisenstr
njursjukdom	njur+sjukdom
läkemedlets	läke+medle(ts)
utseende	utse(ende)
förpackningsstorlekar	förpackning|s+storlek(ar)
gråvita	grå+vit(a)
bikonvexa	bikonvex(a)
inpräglat	inprägla(t)
etnicitet	etnicitet
trabektedins	trabektedins
farmakokinetik	farmako+kinetik
förpackningar	förpackning(ar)
förfyllda	förfylld(a)
sprutor	sprut(or)
easymix	easy+mix
adaptrar	adaptrar
beredning	beredning
injektion	injektion
frankrike	frank+rike
inhalationstiden	inhalation|s+tid(en)
beroende	beroend(e)
patientens	patient(ens)
andningsmönster	andning|s+mönster
intravenös	intra+venös
infusion	infusion
likvärdig	lik+värdig
exponering	exponering
viktområde	vikt+område
betaferon	betaferon
venlafaxin	venlafaxin
uppvisar	uppvisar
kinetik	kinetik
dosintervallet	dos+intervall(et)
hematemes	hematemes
munhemorragi	munhemorragi
abdominalsmärta	abdominal+smärta
tandköttsblödning	tand+kött|s+blödning
proktalgi	prokt+algi
stomatit	stomatit
plasmakoncentrationer	plasma+koncentration(er)
observerats	observerat(s)
njurinsufficiens	njur+insufficiens
behandlas	behandla(s)
förnyat	förnya(t)
godkännande	god+känna(nde)
candidainfektion	candida+infektion
munhåla	mun+håla
filmdragerade	film+dragerad(e)
telbivudin	telbivudin
ovitrelle	ovitrelle
generöst	generös(t)
behandla	behandla
gabapentins	gabapentins
påverkas	påverkas
upprepad	upprepad
protaphane	protaphane
långverkande	lång+verka(nde)
insulin	insulin
blodtryck	blod+tryck
minskat	minska(t)
blodflöde	blod+flöde
färglös	färg+lös
gulaktig	gul+aktig
incidensen	incidens(en)
observerade	observera(de)
trombotiska	trombotiska
tromboemboliska	trombo+embolisk(a)
händelser	händelse(r)
romiplostim	romiplostim
trombocytantal	trombocytantal
observerades	observera(des)
tvåskiktad	två+skiktad
skiktet	skikt(et)
sjukhus	sjuk+hus
transplantationen	transplantationen
hyperkolesterolemi	hyperkolesterolemi
fortfarande	fortfarande
indikation	indikation
huvudsakligen	huvud+saklig(en)
kombination	kombination
ceprotin	ceprotin
malanfall	mal+anfall
svimning	svimning
dyskinesi	dyskinesi
postural	postural
palmoplantar	palmoplantar
erytrodysestesi	erytrodysestesi
föregående	föregående
tidpunkt	tid+punkt
utvärdering	utvärdering
verkningsmekanism	verkning|s+mekanism
hudutslag	hud+utslag
bröstkorgs	bröst+korg(s)
ryggsmärta	rygg+smärta
ospecificerad	ospecificerad
kärlutvidgning	kärl+utvidgning
blodsockervärden	blod+socker+värd(en)
irritation	irritation
bihålorna	bi+hål(orna)
myrkrypningar	myr+krypning(ar)
stickningar	stickning(ar)
kroppen	kropp(en)
sömnsvårigheter	sömn+svårighet(er)
svaghetskänsla	svaghet|s+känsla
smakförändring	smak+förändring
beviljade	bevilja(de)
europeiska	europeisk(a)
kommissionen	kommission(en)
unionen	union(en)
information	information
dialyserade	dialysera(de)
pioglitazon	pioglitazon
således	således
osannolikt	osannolik(t)
aripiprazol	aripiprazol
kliniskt	klinisk(t)
signifikanta	signifikanta
läkemedelsinteraktioner	läke+medel|s+interaktion(er)
enzymer	enzym(er)
rekommenderar	rekommendera(r)
förbehandling	för+behandling
övervägs	övervägs
tumörtillväxt	tumör+tillväxt
riskera	riskera
anatomiska	anatomisk(a)
strukturer	struktur(er)
erfarenhet	erfarenhet
nyligen	nyligen
genomgått	genom+gått
njurtransplantation	njur+transplantation
benmärgsdepression	ben+märg|s+depression
caelyx	caelyx
patienten	patient(en)
informeras	informera(s)
pågående	pågåend(e)
antiretroviral	antiretroviral
inklusive	inklusive
combivir	combivir
minskar	minska(r)
överföring	över+föring
hivinfektion	hiv+infektion
sexuella	sexuell(a)
kontakter	kontakt(er)
detaljerade	detaljerad(e)
injicerar	injicera(r)
bilagan	bilaga(n)
procedur	procedur
självinjektion	själv+injektion
singulair	singulair
orplatna	or+platna
överlevnadstiden	överlevnad|s+tid(en)
förbättring	förbättring
progressionfri	progression+fri
överlevnad	överlevnad
relevant	relevant
fördelar	fördelar
överlevnadstid	överlevnad|s+tid
saknades	saknad(es)
vätskeretention	vät+skeretention
uttalad	uttala(d)
svettning	svettning
nutrition	nutrition
sällsynt	säll+synt
hypokalemi	hypokalemi
eventuellt	eventuellt
marknadsföras	marknad|s+föra(s)
bibehållet	bibehåll(et)
virologiskt	virologisk(t)
behandlingssvar	behandling|s+svar
genotyp	geno+typ
rebetol	rebetol
peginterferon	peginterferon
hematologisk	hematologisk
dosreducering	dos+reducering
uppehåll	uppehåll
kardiovaskulär	kardio+vaskulär
säkerhet	säkerhet
kontraindikation	kontra+indikation
nödvändig	nöd+vändig
omformulering	omformulering
avsnitt	avsnitt
injektionen	injektion(en)
glaskropp	glas+kropp
geléliknande	gelé+liknande
substansen	substans(en)
påbörjas	påbörja(s)
vanligen	vanligen
protopic	protopic
morgonen	morgon(en)
kvällen	kväll(en)
eksemet	eksem(et)
observera	observera
pulvret	pulvret
fullständigt	full+ständig(t)
coversyl	coversyl
clonmel	clonmel
healthcare	health+care
limited	limited
waterford	water+ford
reversibel	reversibel
subkutan	subkutan
enstaka	enstaka
injicerat	injicera(t)
winthrop	winthrop
blodsockernivå	blod+socker+nivå
nikotinsyra	nikotin+syra
genomgår	genomgår
omfattande	omfattande
första	första
passage	passage
metabolismvägar	metabolism+väg(ar)
doshastighetsberoende	dos+hastighet|s+beroend(e)
arixtra	arixtra
fondaparinuxnatrium	fondaparinuxnatrium
nutritionsrubbningar	nutrition|s+rubbning(ar)
ämnesomsättningssjukdomar	ämne+somsättning|s+sjukdom(ar)
serumtriglycerider	serumtriglycerider
förhöjt	förhöj(t)
serumkolesterol	serum+kolesterol
innehållet	innehåll(et)
kolvstången	kolv+stång(en)
laktosmonohydrat	laktos+monohydrat
produktresumén	produkt+resumé(n)
melfalan	melfalan
proceduren	procedur(en)
casodex	casodex
hyperglykemiska	hyper+glykemiska
tillstånd	tillstånd
diabetes	diabetes
mellitus	mellitus
hyperkalemi	hyperkalemi
hypomagnesemi	hypomagnesemi
hypofosfatemi	hypofosfatemi
hypokalcemi	hypokalcemi
hyponatremi	hyponatremi
hyperuricemi	hyperuricemi
minskad	minska(d)
anorexi	anorexi
metabolisk	metabolisk
hyperlipidemi	hyperlipidemi
hypertriglyceridemi	hypertriglyceridemi
elektrolytrubbningar	elektroly+trubbning(ar)
dynastat	dynastat
vårtorna	vårt(orna)
underhållsdos	underhåll|s+dos
preventivmedel	preventiv+medel
docetaxel	docetaxel
behandlingens	behandling(ens)
upphörande	upphöra(nde)
oavsiktligt	oavsiktlig(t)
endosbehållare	endos+behållare
emadine	emadine
potentialen	potential(en)
emedastin	emedastin
intervallet	intervall(et)
beaktas	beakta(s)
adekvat	adekvat
övervakning	över+vakning
klinisk	klinisk
januari	januari
relativt	relativ(t)
utsöndrats	utsöndra(ts)
antibiotikum	anti+biotikum
uppgifter	uppgifter
blister	blister
xenical	xenical
fertilitet	fertilitet
fosterutveckling	foster+utveckling
relaterade	relatera(de)
egenskaper	egenskap(er)
antagonist	antagonist
djurmodeller	djur+modell(er)
dopaminerg	dopaminerg
hyperaktivitet	hyper+aktivitet
agonist	agonist
hypoaktivitet	hypo+aktivitet
riskhanteringsplan	risk+hantering|s+plan
nationella	nationella
representanten	representant(en)
vätskor	vätsk(or)
infusionsvätskor	infusion|s+vätsk(or)
liposom	liposom
dispersion	dispersion
liposomalt	liposomal(t)
doxorubicin	doxorubicin
allvarliga	allvarlig(a)
oönskade	oönskad(e)
kalcitonin	kalcitonin
allergisk	allergisk
reaktion	reaktion
prövningsprogrammet	prövning|s+programm(et)
bröstcancer	bröst+cancer
tilläts	tilläts
modifiering	modifiering
infusionen	infusion(en)
följande	följande
infusionsreaktion	infusion|s+reaktion
injektionsflaskan	injektion|s+flaska(n)
inducerare	inducera(re)
indicerat	indicera(t)
alternativa	alternativ(a)
enzyminduktion	enzym+induktion
viktigt	viktig(t)
