anwendung	anwendung
beachten	beachten
weitere	weitere
warnhinweise	warn+hinweis(e)
vorsichtsmaßnahmen	vorsicht|s+maßnahme(n)
cholestagel	cholestagel
angewendet	angewendet
einnahme	einnahme
bondenza	bondenza
anderen	anderen
arzneimitteln	arznei+mittel(n)
informieren	informieren
apotheker	apotheker
arzneimittel	arznei+mittel
einnehmen	einnehmen
anwenden	anwenden
eingenommen	eingenommen
verschreibungspflichtige	verschreibung|s+pflichtig(e)
handelt	handelt
lietuva	lietuva
dohme	dohme
tumorerkrankungen	tumor+erkrankung(en)
klinischen	klinischen
studien	studien
nummerisches	nummerisches
ungleichgewicht	ungleichgewicht
krebsfällen	krebs+fAll(en)
behandelten	behandelten
gegenüber	gegenüber
kontrollgruppe	kontroll+gruppe
liprolog	liprolog
anweisung	anweisung
filmtablette	film+tablette
enthält	enthält
lactose	lactose
agenerase	agenerase
kapseln	kapseln
vitamin	vitamin
enthalten	enthalten
sollten	sollten
zusätzlich	zusätzlich
haltbarkeit	haltbarkeit
verwendung	verwendung
volumen	volumen
naglazyme	naglazyme
infusionsbeutel	infusion|s+beutel
hinzugefügt	hinzugefügt
werden	werden
ampulle	ampulle
spritze	spritze
spritzen	spritzen
lösungsmittel	lösung|s+mittel
langsam	langsam
insuman	insuman
infusat	infusat
stunden	stunden
raumtemperatur	raum+temperatur
aufbewahrt	aufbewahrt
bilirubinerhöhungen	bilirubin+erhöhung(en)
patienten	patienten
beobachtet	beobachtet
tritace	tritace
epoetin	epoetin
quadratisch	quadratisch
abgerundeten	abgerundeten
überzeugen	überzeugen
visuell	visuell
hebelarm	hebel+arm
vollständig	vollständig
gekommen	gekommen
injektionsnadelspitze	injektion|s+nadel+spitze
bedeckt	bedeckt
zeigten	zeigten
crixivan	crixivan
zidovudin	zidovudin
senkung	senkung
viruslast	virus+last
allein	allein
lagern	lagern
fentanyl-ratiopharm	fentanyl-ratiopharm
besondere	besondere
vorsicht	vorsicht
erforderlich	erforderlich
schwangerschaft	schwangerschaft
humandaten	human+daten
bezüglich	bezüglich
sitaxentan-natrium	sitaxentan-natrium
während	während
wirkstoff	wirk+stoff
stickstoffmonoxid	stickstoff+monoxid
dosiermarke	dosier+marke
mitotan	mitotan
extra-adrenale	extra-adrenale
stoffwechsel	stoff+wechsel
kortisols	kortisols
menschen	menschen
verändert	verändert
reduzierung	reduzierung
messbaren	messbaren
17-hydroxy-kortikosteroide	17-hydroxy-kortikosteroide
plasmaspiegel	plasma+spiegel
kortikosteroide	kortikosteroide
relistor	relistor
empfohlen	empfohlen
flaschen	flaschen
tabletten	tabletten
tierarzneimittel	tier+arznei+mittel
behandlung	behandlung
adulten	adulten
verkehrstüchtigkeit	verkehr|s+tüchtigkeit
bedienen	bedienen
maschinen	maschinen
schwindlig	schwindlig
verschwommen	verschwommen
fahrzeugs	fahrzeugs
werkzeuge	werkzeuge
fühlen	fühlen
schleimhaut	schleim+haut
impfung	impfung
ausfluss	ausfluss
möglich	möglich
direkten	direkten
widersetzt	widersetzt
tablette	tablette
unmittelbar	unmittelbar
verabreichung	verabreichung
angefeuchtetes	angefeuchtetes
feuchtes	feuchtes
belohnungshäppchen	belohnung|s+häppchen
gegeben	gegeben
ambirix	ambirix
anzuwenden	anzuwenden
soliris	soliris
konzentrat	konzentrat
herstellung	herstellung
infusionslösung	infusion|s+lösung
eculizumab	eculizumab
wiederholungsimpfung	wiederholung|s+impfung
informationen	informationen
gewünscht	gewünscht
örtlichen	örtlichen
vertreter	vertreter
pharmazeutischen	pharmazeutischen
unternehmers	unternehmers
verbindung	verbindung
pharmakokinetischen	pharmako+kinetischen
eigenschaften	eigenschaften
kaletra	kaletra
täglich	täglich
insgesamt	insgesamt
kindern	kindern
monaten	monaten
untersucht	untersucht
angegebenen	angegebenen
verfalldatum	verfall+datum
randomisierung	randomisierung
erhielten	erhielten
zeitraum	zeitraum
trudexa	trudexa
placebo	placebo
testkit	test+kit
seltene	seltene
berichtete	berichtete
zusammenhang	zusammenhang
olanzapin	olanzapin
erhalten	erhalten
exfoliatives	exfoliatives
exanthem	exanthem
ekchymose	ekchymose
schwellungen	schwellungen
gesicht	gesicht
idursulfase	idursulfase
zellulären	zellulären
lysosomen	lysosomen
verstoffwechselt	verstoffwechselt
kandidat	kandidat
cytochrom	cytochrom
vermittelte	vermittelte
wechselwirkungen	wechsel+wirkung(en)
tabelle	tabelle
reduzierte	reduzierte
viraferonpeg	viraferonpeg
dosierung	dosierung
kombinationstherapie	kombination|s+therapie
stammlösung	stamm+lösung
angesetzt	angesetzt
maximalkonzentration	maximal+konzentration
präparats	präparats
verwenden	verwenden
solostar	solostar
sichtbare	sichtbare
teilchen	teilchen
injektionslösung	injektion|s+lösung
durchstechflaschen	durch+stech+flasche(n)
durchstechflasche	durch+stech+flasche
plötzlich	plötzlich
aufhören	aufhören
olanzapine	olanzapine
neopharma	neopharma
einzunehmen	einzunehmen
symptome	symptome
schwitzen	schwitzen
schlaflosigkeit	schlaflosigkeit
zittern	zittern
übelkeit	übelkeit
erbrechen	erbrechen
auftreten	auftreten
beschleunigter	beschleunigter
herzschlag	herz+schlag
herzklopfen	herz+klopfen
atembeschwerden	atem+beschwerde(n)
viracept	viracept
geringen	geringen
einfluss	einfluss
pflaster	pflaster
steady-state	steady-state
slovenija	slovenija
farmacevtska	farmacevtska
družba	družba
mikronukleus-studie	mikro+nukleus-studie
dna-reparaturstudie	dna-reparatur+studie
ebenfalls	ebenfalls
negativ	negativ
beginnen	beginnen
gesundheitlichen	gesundheitlichen
probleme	probleme
besprechen	besprechen
dyslipidämie	dyslipidämie
einzelne	einzelne
ivermectin	ivermectin
körpergewicht	körper+gewicht
häufige	häufige
nebenwirkungen	nebenwirkungen
abbruch	abbruch
bortezomib	bortezomib
führten	führten
umfassten	umfassten
neuralgie	neuralgie
periphere	periphere
neuropathie	neuropathie
sensorische	sensorische
thrombozytopenie	thrombozytopenie
verminderte	verminderte
ejektionsfraktion	ejektion|s+fraktion
müdigkeit	müdigkeit
welchen	welchen
doribax	doribax
gezeigt	gezeigt
wirkungen	wirkungen
irbesartan/hydrochlorothiazid-kombination	irbesartan/hydrochlorothiazid-kombination
fertilität	fertilität
tierversuchen	tier+versuch(en)
hinweise	hinweise
beeinträchtigung	beeinträchtigung
irbesartan	irbesartan
hydrochlorothiazid	hydrochlorothiazid
überdosierungen	über+dosierungen
zweifachen	zweifachen
empfohlenen	empfohlenen
berichtet	berichtet
neutropenie	neutropenie
angebracht	angebracht
niedrigen	niedrigen
jeglicher	jeglicher
ursache	ursache
bekannt	bekannt
verursachen	verursachen
können	können
arzneimittelbedingter	arznei+mittel+bedingt(er)
anamnese	anamnese
knochenmarksdepression	knochenmark|s+depression
bedingt	bedingt
begleiterkrankung	begleit+erkrankung
strahlentherapie	strahl|en+therapie
chemotherapie	chemo+therapie
hypereosinophilen	hypereosinophilen
zuständen	zuständen
myeloproliferativen	myeloproliferativen
erkrankung	erkrankung
deutschland	deutschland
janssen-cilag	janssen-cilag
nierenerkrankungen	niere|n+erkrankung(en)
gebrochen	gebrochen
bikonvex	bikonvex
prägung	prägung
auswirkungen	auswirkungen
volksgruppenzugehörigkeit	volk|s+gruppe|n+zugehörigkeit
pharmakokinetik	pharmako+kinetik
trabectedin	trabectedin
packungen	packungen
pulver	pulver
fertigspritzen	fertig+spritze(n)
lösungsmittel	lösungsmittel
easymix-adaptern	easymix-adaptern
rekonstitution	rekonstitution
injektionsnadeln	injektion|s+nadel(n)
frankreich	frankreich
gewicht	gewicht
einheiten	einheiten
inhalationszeit	inhalation|s+zeit
atemmuster	atem+muster
einzelnen	einzelnen
intravenöse	intravenöse
infusion	infusion
clofarabin	clofarabin
erzeugte	erzeugte
äquivalente	äquivalente
exposition	exposition
breiten	breiten
gewichtsbereich	gewicht|s+bereich
betaferon	betaferon
venlafaxin	venlafaxin
lineare	lineare
kinetik	kinetik
dosisbereich	dosis+bereich
hämatemesis	hämatemesis
hämorrhagie	hämorrhagie
bauchschmerzen	bauch+schmerzen
schmerzen	schmerzen
oberbauch	ober+bauch
zahnfleischbluten	zahn+fleisch+bluten
geschwürbildung	geschwür+bildung
proktalgie	proktalgie
stomatitis	stomatitis
dialysepflichtiger	dialyse+pflichtig(er)
niereninsuffizienz	niere|n+insuffizienz
geringere	geringere
plasmakonzentrationen	plasma+konzentration(en)
verlängerung	verlängerung
zulassung	zulassung
nebenwirkungen	neben+wirkung(en)
filmtabletten	film+tablette(n)
telbivudin	telbivudin
ovitrelle	ovitrelle
augenentzündung	auge|n+entzündung
hämatom	hämatom
hitzewallungen	hitze+wallung(en)
oberfläche	oberfläche
läsion	läsion
behandeln	behandeln
möchten	möchten
bestreichen	bestreichen
gabapentin	gabapentin
wiederholter	wiederholter
protaphane	protaphane
wirkendes	wirkendes
insulin	insulin
blutdruck	blut+druck
minderdurchblutung	minder+durchblutung
farblos	farblos
blassgelb	blass+gelb
zwischen	zwischen
ereignissen	ereignissen
erhöhten	erhöhten
thrombozytenzahlen	thrombozyt|en+zahl(en)
schicht	schicht
zeitpunkt	zeit+punkt
operation	operation
verabreicht	verabreicht
hypercholesterinämie	hypercholesterinämie
weiterhin	weiterhin
anwendungsgebiet	anwendung|s+gebiet
kombination	kombination
derartigen	derartigen
ceprotin	ceprotin
vergessen	vergessen
grand-mal-anfall	grand-mal-anfall
synkope	synkope
dyskinesie	dyskinesie
haltungsabhängiger	haltung|s+abhängig(er)
schwindel	schwindel
richtlinien	richtlinien
caelyx-dosismodifikation	caelyx-dosis+modifikation
wirkmechanismus	wirk+mechanismus
behältnis	behältnis
juckreiz	juck+reiz
hautausschlag	haut+ausschlag
rückenschmerzen	rücken+schmerzen
allgemeinen	allgemeinen
gefäßerweiterung	gefäß+erweiterung
anstieg	anstieg
blutzuckerspiegels	blut+zucker+spiegel(s)
verschwommenes	verschwommenes
reizungen	reizungen
nasennebenhöhlendruckgefühl	nase|n+neben+höhle|n+druck+gefühl
taubheitsgefühl	taubheit|s+gefühl
körpers	körpers
schlafstörungen	schlaf+störung(en)
schwächegefühl	schwäche+gefühl
eigenartiger	eigenartiger
geschmack	geschmack
erteilte	erteilte
europäische	europäische
kommission	kommission
unternehmen	unternehmen
genehmigung	genehmigung
inverkehrbringen	in+verkehr+bringen
europäischen	europäischen
pioglitazon	pioglitazon
erwarten	erwarten
aripiprazol	aripiprazol
klinisch	klinisch
bedeutsame	bedeutsame
arzneimittelinteraktionen	arznei+mittel+interaktion(en)
verursacht	verursacht
tumorexpansion	tumor+expansion
lebenswichtige	leben|s+wichtig(e)
anatomische	anatomische
strukturen	strukturen
beeinträchtigen	beeinträchtigen
vorbehandlung	vorbehandlung
kortikosteroiden	kortikosteroiden
betracht	betracht
ziehen	ziehen
erfahrungen	erfahrungen
nierentransplantation	niere|n+transplantation
myokardinfarkt	myokard+infarkt
caelyx	caelyx
darüber	darüber
aufgeklärt	aufgeklärt
derzeit	derzeit
verfügung	verfügung
stehenden	stehenden
therapien	therapien
einschließlich	einschließlich
combivir	combivir
übertragung	übertragung
sexuellen	sexuellen
kontakt	kontakt
kontamination	kontamination
herabsetzen	herabsetzen
ausführliche	ausführliche
anleitung	anleitung
selbstinjektion	selbst+injektion
anhangs	anhangs
gebrauchsanleitung	gebrauch|s+anleitung
singulair	singulair
vergleich	vergleich
erhöhte	erhöhte
orplatna	orplatna
gesamtüberlebenszeit	gesamt+überleben|s+zeit
geringfügigen	geringfügigen
verbesserungen	verbesserungen
progressionsfreien	progression|s+frei(en)
überlebenszeit	überleben|s+zeit
relevant	relevant
erachtet	erachtet
festzustellen	festzustellen
zutreffend	zutreffend
flüssigkeitsretention	flüssigkeit|s+retention
übermäßige	übermäßige
schweißbildung	schweiß+bildung
selten	selten
allergische	allergische
reaktionen	reaktionen
möglicherweise	möglicherweise
packungsgrößen	packung|s+größe(n)
verkehr	verkehr
gebracht	gebracht
hämatologischer	hämatologischer
toxizität	toxizität
anderer	anderer
toxizitäten	toxizitäten
dosisreduktion	dosis+reduktion
verschiebung	verschiebung
notwendig	notwendig
inhaber	inhaber
inverkehrbringen	inverkehrbringen
ansicht	ansicht
gegenanzeige	gegen+anzeige
unbehandelter	unbehandelter
hypertonie	hypertonie
injektion	injektion
erfolgt	erfolgt
glaskörper	glas+körper
welches	welches
gallertartige	gallertartige
augeninneren	augen+innere(n)
street	street
gewöhnlich	gewöhnlich
protopic	protopic
zweimal	zweimal
morgens	morgens
abends	abends
begonnen	begonnen
abklingt	abklingt
manchen	manchen
minuten	minuten
komplett	komplett
aufgelöst	aufgelöst
hypotonie	hypotonie
clonmel	clonmel
healthcare	healthcare
limited	limited
waterford	waterford
reversible	reversible
täglicher	täglicher
intravenöser	intravenöser
subkutaner	subkutaner
einzeldosen	einzel+dosen
täglichen	täglichen
winthrop	winthrop
gespritzt	gespritzt
metabolismus	metabolismus
nicotinsäure	nicotin+säure
unterliegt	unterliegt
ausgeprägten	ausgeprägten
first-pass-metabolismus	first-pass-metabolismus
dosis-resorptionsgeschwindigkeit	dosis-resorption|s+geschwindigkeit
abhängen	abhängen
oberseite	ober+seite
oberschenkels	ober+schenkels
ausnahme	ausnahme
nabelbereichs	nabelbereichs
arixtra	arixtra
fondaparinux-natrium	fondaparinux-natrium
serumtriglyzeride	serum+triglyzeride
erhöhtes	erhöhtes
serumcholesterin	serum+cholesterin
gesamten	gesamten
fertigspritze	fertig+spritze
stempel	stempel
herunterdrücken	herunterdrücken
fachinformation	fach+information
melphalan	melphalan
casodex	casodex
hyperglykämische	hyperglykämische
zustände	zustände
diabetes	diabetes
mellitus	mellitus
hyperkaliämie	hyperkaliämie
hypomagnesiämie	hypomagnesiämie
hypophosphatämie	hypophosphatämie
hypokaliämie	hypokaliämie
hypokalzämie	hypokalzämie
hyponatriämie	hyponatriämie
flüssigkeitsüberbelastung	flüssigkeit|s+überbelastung
hyperurikämie	hyperurikämie
appetitverminderung	appetit+verminderung
anorexie	anorexie
metabolische	metabolische
azidose	azidose
hyperlipidämie	hyperlipidämie
hypertriglyceridämie	hypertriglyceridämie
elektrolytstörungen	elektrolyt+störungen
dynastat	dynastat
einwirken	einwirken
lassen	lassen
übliche	übliche
erhaltungsdosis	erhaltung|s+dosis
therapie	therapie
mindestens	mindestens
beendigung	beendigung
kontrazeptive	kontrazeptive
maßnahmen	maßnahmen
getroffen	getroffen
emedastin	emedastin
qt-intervalls	qt-intervalls
bewirken	bewirken
versehentlicher	versehentlicher
flascheninhalts	flasche|n+inhalt(s)
emadine	emadine
entsprechend	entsprechend
überwacht	überwacht
geeignete	geeignete
eingeleitet	eingeleitet
relativ	relativ
kontrollarm	kontroll+arm
ausgeschieden	ausgeschieden
fusidinsäure	fusidin+säure
mindestangaben	mindest+angaben
blisterpackungen	blister+packung(en)
folienstreifen	folie|n+streifen
xenical	xenical
kaninchen	kaninchen
embryofetale	embryo+fetale
entwicklung	entwicklung
toxischen	toxischen
tiermodell	tier+modell
antagonistische	antagonistische
dopaminerger	dopaminerger
hyperaktivität	hyper+aktivität
agonistische	agonistische
hypoaktivität	hypo+aktivität
management	management
angaben	angaben
beimischungen	beimischungen
liposomalen	liposomalen
infusionsdispersion	infusion|s+dispersion
liposomales	liposomales
doxorubicin	doxorubicin
umgehend	umgehend
krankenschwester	kranke|n+schwester
nachstehend	nachstehend
aufgeführten	aufgeführten
bemerken	bemerken
einzige	einzige
ernsthafte	ernsthafte
nebenwirkung	neben+wirkung
lachs-calcitonin	lachs-calcitonin
behandelte	behandelte
gemeldet	gemeldet
reaktion	reaktion
prüfungen	prüfungen
mammakarzinoms	mammakarzinoms
patientinnen	patientinnen
infusionsreaktion	infusion|s+reaktion
folgende	folgende
modifikation	modifikation
erlaubt	erlaubt
gummistopfen	gummi+stopfen
äusseren	äusseren
umhüllung	umhüllung
cyp3a4-induktoren	cyp3a4-induktoren
indiziert	indiziert
therapeutika	therapeutika
geringerem	geringerem
potenzial	potenzial
enzyminduktion	enzym+induktion
auszuwählen	auszuwählen
wichtig	wichtig
verlauf	verlauf
unterziehen	unterziehen
keinerlei	keinerlei
eingestellt	eingestellt
patrone	patrone
verbliebene	verbliebene
dosisvorwahlknopfes	dosis+vorwahl+knopf(es)
injiziert	injiziert
gleichen	gleichen
insulindosis	insulin+dosis
benötigen	benötigen
stillzeit	still+zeit
stechen	stechen
injektionsnadel	injektion|s+nadel
sterilen	sterilen
injektionsspritze	injektion|s+spritze
durchstechflasche	durchstech+flasche
verbunden	verbunden
aufbewahrung	aufbewahrung
zerteilter	zerteilter
verwendeter	verwendeter
abschnitt	abschnitt
entzündung	entzündung
schleimhaut	schleim+haut
speiseröhre	speise+röhre
darmlähmung	darm+lähmung
bluterbrechen	blut+erbrechen
produkt	produkt
verwendet	verwendet
verfärbt	verfärbt
schwebstoffe	schweb+stoffe
vorhanden	vorhanden
besserung	besserung
bereits	bereits
therapiebeginn	therapie+beginn
festgestellt	festgestellt
transdermale	transdermale
gleichzeitigen	gleichzeitigen
standard-doxorubicin-hcl	standard-doxorubicin-hcl
wechselwirkungen	wechsel+wirkungen
zeigen	zeigen
geboten	geboten
individueller	individueller
schwankungsmöglichkeiten	schwankung|s+möglichkeit(en)
einstellung	einstellung
optimalen	optimalen
therapeutischen	therapeutischen
individuell	individuell
erfolgen	erfolgen
integrilin	integrilin
aussieht	aussieht
packung	packung
übertragbarkeit	übertragbarkeit
wirksamkeitsdaten	wirksamkeit|s+daten
cervarix	cervarix
jungen	jungen
erwachsenen	erwachsenen
mädchen	mädchen
galaktoseintoleranz	galaktose+intoleranz
seltenen	seltenen
hereditären	hereditären
lapp-lactase-mangel	lapp-lactase-mangel
galaktose-malabsorption	galaktose-malabsorption
astellas	astellas
lamivudin	lamivudin
hbv-infektion	hbv-infektion
zusätzliche	zusätzliche
hepatitis-b-infektionen	hepatitis-b-infektionen
prevenar	prevenar
einzeldosis-fertigspritze	einzel+dosis-fertig+spritze
separater	separater
meisten	meisten
leberwertanomalien	leber+wert+anomalie(n)
bildeten	bildeten
dosisanpassung	dosis+anpassung
absetzen	absetzen
zurück	zurück
wirksamkeit	wirksamkeit
sicherheit	sicherheit
prograf	prograf
ciclosporin	ciclosporin
advagraf	advagraf
jeweils	jeweils
basiliximab-antikörperinduktion	basiliximab-anti+körper+induktion
nierentransplantatempfängern	niere|n+transplantat+empfänger(n)
verglichen	verglichen
mirapexin	mirapexin
octreotid/lanreotid	octreotid/lanreotid
insulinbedarf	insulin+bedarf
erhöhen	erhöhen
kontrollieren	kontrollieren
einmal	einmal
stellen	stellen
richtige	richtige
tevagrastim-dosis	tevagrastim-dosis
bewertung	bewertung
häufigkeitsangaben	häufigkeit|s+angabe(n)
zugrunde	zugrunde
gelegt	gelegt
schwerem	schwerem
kongenitalem	kongenitalem
protein-c-mangel	protein-c-mangel
besserte	besserte
purpura	purpura
fulminans	fulminans
episoden	episoden
cumarin-induzierter	cumarin-induzierter
hautnekrose	haut+nekrose
planen	planen
atorvastatin	atorvastatin
stiegen	stiegen
enviage	enviage
effentora	effentora
feuchtigkeit	feuchtigkeit
wirkstoff	wirkstoff
freigesetzt	freigesetzt
ängstlichkeit	ängstlichkeit
verwirrung	verwirrung
kopfschmerzen	kopf+schmerz(en)
ohnmachtsanfälle	ohnmacht|s+anfAll(e)
niedriger	niedriger
benommenheit	benommenheit
erröten	erröten
einigen	einigen
blutuntersuchungen	blut+untersuchung(en)
verschlechterung	verschlechterung
hepatitis	hepatitis
truvada	truvada
positioniert	positioniert
material	material
flüssigkeit	flüssigkeit
umgekehrten	umgekehrten
entnommen	entnommen
subkutane	subkutane
sekunden	sekunden
dauern	dauern
osigraft	osigraft
gonal-f	gonal-f
follitropin	follitropin
tesavel	tesavel
erkrankungen	erkrankungen
lymphsystems	lymph+system(s)
natriumhydroxid	natrium+hydroxid
salzsäure	salz+säure
ph-einstellung	ph-einstellung
kontrazeptiva	kontrazeptiva
avandamet	avandamet
rosiglitazon/metformin-hcl	rosiglitazon/metformin-hcl
risiken	risiken
rapilysin	rapilysin
erhaltungsdosen	erhaltung|s+dosen
herabsetzung	herabsetzung
tacrolimus-blutspiegel	tacrolimus-blutspiegel
verzeichnen	verzeichnen
paliperidon	paliperidon
solchen	solchen
muttermilch	mutter+milch
therapeutischer	therapeutischer
stillenden	stillenden
müttern	müttern
gestillten	gestillten
säugling	säugling
rechnen	rechnen
inkompatibilitäten	inkompatibilitäten
älteren	älteren
wurden	wurden
eu-nummer	eu-nummer
wirkung	wirkung
beeinflussen	beeinflussen
müssen	müssen
fähigkeit	fähigkeit
durchgeführt	durchgeführt
cysteamin-augentropfen	cysteamin-augen+tropfen
fortgesetzt	fortgesetzt
mycamine	mycamine
candidose	candidose
genauso	genauso
wirksam	wirksam
vergleichspräparate	vergleich|s+präparat(e)
kontrollierten	kontrollierten
hinweis	hinweis
vermehrtes	vermehrtes
überempfindlichkeitsreaktionen	überempfindlichkeit|s+reaktion(en)
immunität	immunität
grundimmunisierung	grund+immunisierung
nachgewiesen	nachgewiesen
normalerweise	normalerweise
innerhalb	innerhalb
hydrochlorothiazide	hydrochlorothiazide
ausgeglichen	ausgeglichen
aushilfsleistungen	aushilf|s+leistung(en)
aufzubewahren	aufzubewahren
versehentliche	versehentliche
schmerzhaft	schmerzhaft
österreich	österreich
austria	austria
tipografilor	tipografilor
unbeabsichtigt	unbeabsichtigt
anwendungen	anwendungen
signifikanten	signifikanten
valtropin	valtropin
einzuleiten	einzuleiten
überwachen	überwachen
entsprechende	entsprechende
erfahrung	erfahrung
diagnose	diagnose
betreuung	betreuung
wachstumshormonmangel	wachstum|s+hormon+mangel
besitzen	besitzen
pradaxa	pradaxa
vorbeugung	vorbeugung
bildung	bildung
blutgerinnseln	blut+gerinnsel(n)
eingesetzt	eingesetzt
granulat	granulat
verabreichen	verabreichen
gesteckt	gesteckt
einstellen	einstellen
doppelte	doppelte
versäumte	versäumte
nachzuholen	nachzuholen
schwerwiegendere	schwer+wiegendere
stimmung	stimmung
alsfelder	alsfelder
erwartet	erwartet
abacavir	abacavir
menschliche	menschliche
übergeht	übergeht
bestätigt	bestätigt
verhärtungen	verhärtungen
wundstellen	wund+stellen
schorfbildung	schorf+bildung
abheilung	abheilung
bläschenbildung	bläschen+bildung
mahlzeit	mahlzeit
subkutan	subkutan
intramuskuläre	intramuskuläre
vertragen	vertragen
lediglich	lediglich
vorübergehende	vorübergehende
leichte	leichte
schwellung	schwellung
injektionsstelle	injektion|s+stelle
weniger	weniger
bedingungen	bedingungen
beschränkungen	beschränkungen
pi-basierende	pi-basierende
studienbeginn	studien+beginn
aspartam	aspartam
süßstoff	süßstoff
erneute	erneute
vorhersagbarkeit	vorhersagbarkeit
anhaltendes	anhaltendes
virologisches	virologisches
ansprechen	ansprechen
theoretisch	theoretisch
überdosis	überdosis
signifikante	signifikante
hemmung	hemmung
arbeiten	arbeiten
meiden	meiden
potenziell	potenziell
gefährlich	gefährlich
wachsamkeit	wachsamkeit
konzentrationsfähigkeit	konzentration|s+fähigkeit
erfordern	erfordern
durchfall	durchfall
rasilez	rasilez
aufrecht	aufrecht
stehend	stehend
aufbewahren	aufbewahren
tasmar®	tasmar®
filmtabletten	film+tabletten
geringe	geringe
zunahme	zunahme
inzidenz	inzidenz
leberadenomen	leber+adenom(en)
beobachten	beobachten
behandelt	behandelt
denjenigen	denjenigen
avlona	avlona
griechenland	griechenland
catalent	catalent
packaging	packaging
headway	headway
oakley	oakley
northamptonshire	northamptonshire
vereinigtes	vereinigtes
königreich	königreich
retacrit	retacrit
ausschuss	ausschuss
schluss	schluss
atripla	atripla
praktische	praktische
bestehende	bestehende
aufrechterhaltung	aufrecht+erhaltung
genügend	genügend
vorliegen	vorliegen
gesicherte	gesicherte
aussage	aussage
vorbehandelten	vorbehandelten
treffen	treffen
myozyme	myozyme
alpha-glucosidase	alpha-glucosidase
ersetzen	ersetzen
hellgelbe	hell+gelb(e)
bikonvexe	bikonvexe
aufdruck	aufdruck
handschuhe	hand+schuh(e)
breiter	breiter
company	company
operations	operations
fleming	fleming
liverpool	liverpool
szintillationsröhrchen	szintillation|s+röhrchen
gastrointestinale	gastrointestinale
blutungen	blutungen
humaninsulinen	human+insulin(en)
sanofi-aventis	sanofi-aventis
gemischt	gemischt
insulinen	insulinen
speziell	speziell
einsatz	einsatz
insulinpumpen	insulin+pumpe(n)
bestimmt	bestimmt
pigmentierung	pigmentierung
nesselsucht	nessel+sucht
facharzt	fach+arzt
rheumatoider	rheumatoider
arthritis	arthritis
psoriasis-arthritis	psoriasis-arthritis
erfahren	erfahren
copalia	copalia
auftritt	auftritt
patient	patient
liegende	liegende
position	position
