TUDNIVALÓK	TUDNI+VALÓ(K)
ALKALMAZÁSA	ALKALMAZÁSA
különleges	különleges
figyelmeztetések	figyelmeztetések
alkalmazással	alkalmazással
kapcsolatos	kapcsolatos
óvintézkedések	óv+intézkedés(ek)
fogászati	fogászati
kezelés	kezelés
szájsebészeti	száj+sebészet(i)
beavatkozás	beavatkozás
közölje	közölje
fogorvosával	fog+orvos(ával)
Lietuva	Lietuva
Malignitások	Malignitások
klinikai	klinikai
vizsgálatok	vizsgálatok
különbséget	különbséget
figyeltek	figyeltek
Xolair-	Xolair-
csoportban	csoportban
illetve	illetve
kontroll-	kontroll-
kialakuló	kialakuló
daganatos	daganatos
megbetegedések	megbetegedések
pontosan	pontosan
alkalmazza	alkalmazza
Liprolog	Liprolog
kezelőorvosa	kezel|ő+orvos(a)
előírta	előírta
vízmentes	víz+mentes
filmtablettánként	film+tablettÁ(nként)
Agenerase	Agenerase
kapszula	kapszula
vitamint	vitamint
tartalmaz	tartalmaz
további	további
vitamin	vitamin
szedésére	szedésére
szükség	szükség
Felhasználhatósági	Felhasználhatósági
időtartam	idő+tartam
használata	használata
Naglazyme	Naglazyme
beadható	beadható
közvetlenül	közvetlenül
infúziós	infúziós
tartalmazó	tartalmazó
ampullát	ampullát
fecskendőt	fecskendőt
fecskendezze	fecskendezze
oldószert	oldó+szert
ampullába	ampullába
Használat	Használat
Insuman	Insuman
Infusat-	Infusat-
keresztül	keresztül
szobahőmérsékleten	szoba+hőmérséklet(en)
tartani	tartani
fokozatú	fokozatú
bilirubin	bilirubin
emelkedést	emelkedést
betegek	betegek
mellkasban	mell+kas(ban)
súlyosabb	súlyosabb
szívbetegségek	szív+betegség(ek)
beleértve	beleértve
szívinfarktust	szív+infarktus(t)
agyvérzést	agy+vérzés(t)
EPOETIN	EPOETIN
Négyzet	Négyzet
lekerekített	lekerekített
sarkokkal	sarkokkal
Győződjön	Győződjön
felemelő	felemelő
billentyűt	billentyűt
egészen	egészen
lefedett	lefedett
állapotban	állapotban
vizsgálat	vizsgálat
Crixivant	Crixivant
zidovudint	zidovudint
többnek	többnek
csökkent	csökkent
vírusterhelése	vírus+terhelés(e)
kezelést	kezelést
követően	követően
Crixivannal	Crixivannal
kezeltek	kezeltek
Legfeljebb	Legfeljebb
tárolandó	tárolandó
FENTANYL-	FENTANYL-
RATIOPHARM	RATIOPHARM
fokozott	fokozott
elővigyázatossággal	elővigyázatossággal
alkalmazható	alkalmazható
Terhesség	Terhesség
szitaxentán-	szitaxentán-
nátrium	nátrium
terhesség	terhesség
történő	történő
alkalmazásával	alkalmazásával
kapcsolatban	kapcsolatban
rendelkezésre	rendelkezésre
emberre	emberre
vonatkozó	vonatkozó
készítmény	készítmény
hatóanyaga	hat|ó+anyag(a)
nitrogén-	nitrogén-
monoxid	monoxid
Adagjelző	adag+jelző
mitotan	mitotan
emberben	emberben
módosítja	módosítja
kortizol	kortizol
mellékvesén	mellék+vesÉ(n)
metabolizmusát	metabolizmusát
csökkentve	csökkentve
mérhető	mérhető
hidroxi-	hidroxi-
kortikoszteroid	kortikoszteroid
szinteket	szinteket
miközben	miközben
corticosteroid	corticosteroid
szintje	szintje
változik	változik
metilnaltrexon-	metilnaltrexon-
gyakorolt	gyakorolt
RELISTOR	RELISTOR
alkalmazása	alkalmazása
terhességben	terhességben
ajánlott	ajánlott
feltétlenül	feltétlenül
mindegyik	mindegyik
kiszerelés	kiszerelés
kereskedelmi	kereskedelmi
forgalomba	forgalomba
állatgyógyászati	állat+gyógyászat(i)
kullancsok	kullancsok
kifejlett	kifejlett
fertőződésének	fertőződésének
kezelésére	kezelésére
szolgál	szolgál
hatásai	hatásai
gépjárművezetéshez	gép+jármű+vezetés+(hez)
kezeléséhez	kezeléséhez
szükséges	szükséges
képességre	képességre
Amennyiben	Amennyiben
homályossá	homályossá
szedésének	szedésének
vezessen	vezessen
gépjárművet	gépjárművet
kezeljen	kezeljen
gépeket	gépeket
vakcinázás	vakcinázás
rektális	rektális
hőmérséklet	hő+mérséklet
legfeljebb	legfeljebb
megemelkedhet	megemelkedhet
lehetséges	lehetséges
ellenáll	ellen+áll
készítményt	készítményt
szájába	szájába
helyezzük	helyezzük
tablettát	tablettát
kismennyiségű	kis+mennyiség(ű)
nedvesített	nedvesített
eledelbe	eledelbe
AMBIRIX-	AMBIRIX-
Soliris	Soliris
koncentrátum	koncentrátum
oldatos	oldatos
infúzióhoz	infúzióhoz
Ekulizumab	Ekulizumab
Emlékeztető	Emlékeztető
készítményhez	készítményhez
kapcsolódó	kapcsolódó
kérdéseivel	kérdéseivel
forduljon	forduljon
hozatali	hozatali
engedély	engedély
jogosultjának	jogosultjának
képviseletéhez	képviseletéhez
Kaletra	Kaletra
farmakokinetikáját	farmakokinetikáját
összesen	összesen
közötti	közötti
gyermeken	gyermeken
vizsgálták	vizsgálták
kétszer	kétszer
csomagoláson	csomagoláson
feltüntetett	feltüntetett
lejárati	lejárati
Levviax-	Levviax-
feliratú	feliratú
mintavételi	minta+vétel(i)
csöveket	csöveket
Felbontás	Felbontás
használható	használható
megkezdett	megkezdett
fölhasználási	fölhasználási
határideje	határ+idE(je)
előfordulását	előfordulását
olanzapin-	olanzapin-
kapcsán	kapcsán
jelentettek	jelentettek
gyakori	gyakori
exfoliatív	exfoliatív
bőrkiütés	bőr+kiütés
ecchymosis	ecchymosis
feldagadása	feldagadása
celluláris	celluláris
lizoszómákban	lizoszómákban
metabolizmus	metabolizmus
alapján	alapján
várható	várható
idurszulfáz	idurszulfáz
citokróm	citokróm
enzimek	enzimek
közvetített	közvetített
kölcsönhatásokban	kölcsön+hatás(okban)
táblázat	táblázat
Csökkentett	Csökkentett
ViraferonPeg	ViraferonPeg
kombinációs	kombinációs
törzsoldatot	törzs+oldat(ot)
maximális	maximális
koncentráció	koncentráció
keveréket	keveréket
keverni	keverni
használja	használja
SoloStart-	SoloStart-
látható	látható
részecskéket	részecskéket
Oldatos	Oldatos
injekció	injekció
injekciós	injekciós
üvegenként	üvegenként
hirtelen	hirtelen
abbahagyja	abbahagyja
OLANZAPINE	OLANZAPINE
NEOPHARMA	NEOPHARMA
szedését	szedését
előfordulhat	előfordulhat
verejtékezés	verejtékezés
álmatlanság	álmatlanság
remegés	remegés
nyugtalanság	nyugtalanság
hányinger	hány+inger
szívverés	szív+verés
szívdobogásérzés	szív+dobogás+érzés
nehezített	nehezített
VIRACEPT	VIRACEPT
elhanyagolható	elhanyagolható
mértékben	mértékben
befolyásolja	befolyásolja
képességeket	képességeket
tapaszt	tapaszt
másikat	másikat
hordani	hordani
minimális	minimális
plazmakoncentrációja	plazma+koncentráció(ja)
farmacevtska	farmacevtska
Patkányokon	Patkányokon
végzett	végzett
micronucleus	micronucleus
szintén	szintén
negatív	negatív
eredménnyel	eredménnyel
Zeffix-	Zeffix-
megelőzően	megelőzően
beszélnie	beszélnie
egészségügyi	egészség+ügy|i
problémáit	problémáit
kezelőorvosával	kezel|ő+orvos(ával)
TUDOMÁNYOS	TUDOMÁNYOS
KÖVETKEZTETÉSEK	KÖVETKEZTETÉSEK
bortezomib	bortezomib
Caelyx-	Caelyx-
leállítását	leállítását
eredményező	eredményező
nemkívánatos	nem+kívánatos
események	események
neuralgia	neuralgia
perifériás	perifériás
neuropátia	neuropátia
szenzoros	szenzoros
thrombocytopenia	thrombocytopenia
ejekciós	ejekciós
frakció	frakció
kimerültség	kimerültség
szerepeltek	szerepeltek
előnyei	előnyei
Doribax	Doribax
alkalmazásának	alkalmazásának
Adagológomb	adagol|ó+gomb
beállító	beállító
irbezartán/	irbezartán/
hidroklorotiazid	hidroklorotiazid
kombináció	kombináció
fertilitásra	fertilitásra
hatását	hatását
állatokban	állatokban
bizonyíték	bizonyíték
irbezartán	irbezartán
önállóan	önállóan
alkalmazva	alkalmazva
hatással	hatással
állatok	állatok
nemzőképességére	nemz|ő+képesség(ére)
javasolt	javasolt
terápiás	terápiás
kétszeresének	kétszeresének
megfelelő	megfelelő
túladagolásról	túl+adagolás(ról)
számoltak	számoltak
Neutropenia	Neutropenia
vigyázatosság	vigyázatosság
következő	következő
esetekben	esetekben
bármely	bármely
kialakult	kialakult
leukopenia	leukopenia
neutropenia	neutropenia
ismerten	ismerten
neutropeniát	neutropeniát
gyógyszeres	gyógyszeres
gyógyszer	gyógyszer
kiváltott	kiváltott
csontvelő	csont+velő
depresszió/	depresszió/
toxicitás	toxicitás
kórelőzményben	kór+előzmény(ben)
társbetegség	társ+betegség
csontvelődepresszió	csont+velő+depresszió
kemoterápia	kemo+terápia
hypereosinophiliával	hypereosinophiliával
myeloproliferativ	myeloproliferativ
kórképek	kór+kép(ek)
Deutschland	Deutschland
JANSSEN-	JANSSEN-
Raiffeisenstr	Raiffeisenstr
Vesebetegség	Vese+betegség
külleme	külleme
csomagolás	csomagolás
Irbesartan	Irbesartan
tabletta	tabletta
csaknem	csaknem
domború	domború
felületű	felületű
oldalán	oldalán
mélynyomással	mély+nyomás(sal)
mélynyomású	mély+nyomás(ú)
jelzéssel	jelzéssel
ellátott	ellátott
trabektedin	trabektedin
tanulmányozták	tanulmányozták
különböző	különböző
etnikumok	etnikumok
körében	körében
oldószerrel	old|ó+szer(rel)
előretöltött	előre+töltött
feloldásra	feloldásra
szolgáló	szolgáló
EasyMIX	EasyMIX
adaptert	adaptert
beadásra	beadásra
csomagban	csomagban
Francia	Francia
inhalálási	inhalálási
lélegzésének	lélegzésének
jellegzetességeitől	jellegzetességeitől
klofarabin	klofarabin
intravénás	intravénás
infúzióban	infúzióban
beadott	beadott
súlytartományban	súly+tartomány(ban)
eredményezett	eredményezett
egyenértékű	egyen+érték(ű)
expozíciót	expozíciót
korábban	korábban
depresszióban	depresszióban
szenvedett	szenvedett
jelenleg	jelenleg
depressziós	depressziós
támadtak	támadtak
venlafaxin	venlafaxin
dózistartományban	dózis+tartomány(ban)
lineáris	lineáris
kinetikát	kinetikát
mutatott	mutatott
Kiszáradás	Kiszáradás
anorexia	anorexia
Anyagcsere	anyag+csere
táplálkozási	táplálkozási
betegségek	betegségek
szorongás	szorongás
Pszichés	Pszichés
zavarok	zavarok
Gyakori	Gyakori
izgatottság	izgatottság
ingerlékenység	ingerlékenység
fejfájás	fej+fájás
Idegrendszeri	ideg+rendszer(i)
neuropathia	neuropathia
paraesthesia	paraesthesia
aluszékonyság	aluszékonyság
szédülés	szédülés
hallásromlás	hallás+romlás
labyrinthus	labyrinthus
betegségei	betegségei
pericardialis	pericardialis
folyadékgyülem	folyadék+gyülem
tachycardia	tachycardia
Szívbetegségek	Szív+betegség(ek)
kipirulás	kipirulás
Érrendszeri	ér+rendszer(i)
hypotensio	hypotensio
haematoma	haematoma
Légzőrendszeri	légző+rendszer(i)
mellkasi	mell+kas(i)
mediastinalis	mediastinalis
mérsékelt	mérsékelt
vesekárosodásban	vese+károsodás(ban)
szenvedő	szenvedő
betegekben	betegekben
plazmakoncentrációk	plazma+koncentráció(k)
megduplázódását	megduplázódását
figyelték	figyelték
mindazonáltal	mindazonáltal
veseelégtelenségben	vese+elégtelenség(ben)
hemodialízissel	hemodialízissel
alacsonyabb	alacsonyabb
plazmaszinteket	plazma+szint(eket)
megújításának	megújításának
Gyakoriság	gyakoriság
filmtabletta	film+tabletta
telbivudin	telbivudin
GYÓGYSZER	gyógy+szer
OVITRELLE	OVITRELLE
BETEGSÉGEK	betegségek
ALKALMAZHATÓ?	ALKALMAZHATÓ?
Hyperhidrosis	Hyperhidrosis
Pelenka-	Pelenka-
dermatitis	dermatitis
bőségesen	bőségesen
kezelendő	kezelendő
bőrterület	bőr+terület
felületére	felületére
ismételt	ismételt
adagolás	adagolás
gabapentin	gabapentin
farmakokinetikájára	farmakokinetikájára
Protaphane	Protaphane
hatástartamú	hatás+tarta(mú)
inzulin	inzulin
vérnyomás	vér+nyomás
lelassult	lelassult
véráramlás	vér+áramlás
Feloldódás	feloldódás
oldatnak	oldatnak
tisztának	tisztának
színtelennek	színtelennek
halványsárgának	halvány+sárgÁ(nak)
Klinikai	Klinikai
thromboticus/	thromboticus/
thromboemboliás	thromboemboliás
szövődmények	szövődmények
előfordulási	előfordulási
gyakorisága	gyakorisága
hasonló	hasonló
romiplosztimmal	romiplosztimmal
placebóval	placebóval
összefüggést	összefüggést
valamint	valamint
emelkedett	emelkedett
vérlemezkeszám	vér+lemezke+szám
kétrétegű	két+réteg(ű)
rétegen	rétegen
ellátva	ellátva
kórházban	kór+ház(ban)
szervátültetése	szerv+átültetés(e)
időszakban	idő+szak(ban)
hiperkoleszterinémia	hiperkoleszterinémia
indikáció	indikáció
főképpen	főképpen
diszlipidémiával	diszlipidémiával
kombinálva	kombinálva
elfelejtette	elfelejtette
bevenni	bevenni
CEPROTIN-	CEPROTIN-
epilepsziás	epilepsziás
nagyroham	nagy+roham
diszkinézia	diszkinézia
poszturális	poszturális
PLANTARIS	PLANTARIS
ERYTHRODYSAESTHESIA	ERYTHRODYSAESTHESIA
beadása	beadása
hatásmechanizmusa	hatás+mechanizmus(a)
dobozon	dobozon
Combivir-	Combivir-
gyakran	gyakran
észlelt	észlelt
mellékhatások	mellék+hatás(ok)
következők	következők
fájdalom	fájdalom
véraláfutás	vér+alá+futás
zsibbadás	zsibbadás
Európai	Európai
Bizottság	Bizottság
részére	részére
Ziagen-	Ziagen-
vonatkozóan	vonatkozóan
megadta	megadta
területére	területére
érvényes	érvényes
engedélyt	engedélyt
Dializált	Dializált
tapasztalat	tapasztalat
esetében	esetében
pioglitazon	pioglitazon
valószínű	valószínű
aripiprazol	aripiprazol
klinikailag	klinikailag
jelentős	jelentős
gyógyszerinterakciókat	gyógyszer+interakció(kat)
enzimeken	enzimeken
Kortikoszteroiddal	Kortikoszteroiddal
előkezelés	előkezelés
azoknál	azoknál
betegeknél	betegeknél
akiknél	akiknél
lokális	lokális
növekedése	növekedése
létfontosságú	lét+fontosság(ú)
szerveket	szerveket
veszélyeztethet	veszélyeztethet
Vesetranszplantáción	vese+transzplantáció(n)
frissen	frissen
átesett	átesett
kezelésével	kezelésével
urticaria	urticaria
onycholysis	onycholysis
Caelyx?	Caelyx?
betegeket	betegeket
tájékoztatni	tájékoztatni
jelenlegi	jelenlegi
retrovírus-	retro+vírus-
ellenes	ellenes
terápia	terápia
megelőzné	megelőzné
fertőzés	fertőzés
szexuális	szexuális
érintkezés	érintkezés
átvitelét	átvitelét
személyekre	személyekre
Betaferon	Betaferon
injekciózására	injekciózására
részletes	részletes
útmutatások	út+mutatás(ok)
Függelék	Függelék
részében	részében
öninjekciózás	ön+injekciózás
folyamata	folyamata
olvashatók	olvashatók
SINGULAIR	SINGULAIR
SZEDÉSE	SZEDÉSE
összehasonlítva	összehasonlítva
Orplatna	Orplatna
növelte	növelte
átlagos	átlagos
túlélési	túl+élés|i
progressziómentes	progresszió+mentes
túlélés	túlélés
vonatkozásában	vonatkozásában
mutatkozó	mutatkozó
kismértékű	kis+mérték|ű
javulást	javulást
tekintették	tekintették
relevánsnak	relevánsnak
túlélséi	túlélséi
következett	következett
javulás	javulás
értelmezhető	értelmezhető
folyadékvisszatartás	folyadék+visszatartás
nagymértékű	nagy+mérték|ű
hypokalaemia	hypokalaemia
tünetek	tünetek
vizsgálat2	vizsgálat2
haematológiai	haematológiai
dóziscsökkentést	dózis+csökkentés(t)
késleltetést	késleltetést
igényelhet	igényelhet
jogosultja	jogosultja
véleményen	véleményen
kontrollált	kontrollált
hipertóniában	hipertóniában
ellenjavallat	ellen+javallat
indokolt	indokolt
injekciót	injekciót
üvegtestébe	üveg+test(ébe)
található	található
Vaniqa?	Vaniqa?
általában	általában
Protopic	Protopic
kenőccsel	kenőccsel
kezdődik	kezdődik
naponta	naponta
alkalmazni	alkalmazni
egyszer	egyszer
megszűnéséig	megszűnéséig
Bizonyos	Bizonyos
feloldódása	feloldódása
igénybe	igénybe
COVERSYL	COVERSYL
Clonmel	Clonmel
Healthcare	Healthcare
Limited	Limited
Waterford	Waterford
Harminc	Harminc
subcutan	subcutan
adagolást	adagolást
reverzíbilis	reverzíbilis
tapasztaltak	tapasztaltak
kimutatható	kimutatható
egyszeri	egyszeri
dózisokat	dózisokat
előírtnál	előírtnál
Insulin	Insulin
Winthrop	Winthrop
alkalmazott	alkalmazott
vércukorszintje	vér+cukor+szint(je)
Metabolizmus	Metabolizmus
Nikotinsav	nikotin+sav
nikotinsav	nikotinsav
metabolizmuson	metabolizmuson
dózisarány-	dózis+arány-
útvonalon	út+vonal(on)
Arixtra	Arixtra
Fondaparinux-	Fondaparinux-
trigliceridszint	trigliceridszint
koleszterinszint	koleszterin+szint
tablettánként	tablettánként
eljárás	eljárás
megkezdése	megkezdése
olvassa	olvassa
melfalan	melfalan
alkalmazási	alkalmazási
előírását	előírását
Casodex	Casodex
hyperglykaemiás	hyperglykaemiás
állapotok	állapotok
diabetes	diabetes
mellitus	mellitus
hyperkalaemia	hyperkalaemia
Dynastat	Dynastat
szemölcsös	szemölcsös
területen	területen
Szokásos	Szokásos
fenntartó	fenn+tart|ó
befejezése	befejezése
legalább	legalább
hónapig	hónapig
gondoskodni	gondoskodni
fogamzásgátlásról	fogamzás+gátlás(ról)
tartály	tartály
EMADINE	EMADINE
mennyiségének	mennyiségének
véletlenszerű	véletlen+szerű
lenyelésekor	lenyelésekor
emedasztin	emedasztin
hatására	hatására
megnyúlhat	megnyúlhat
szakasz	szakasz
esetben	esetben
megfigyelése	megfigyelése
kezelése	kezelése
analízis	analízis
zárópontnál	zár|ó+pont(nál)
Elsődleges	Elsődleges
kontroll	kontroll
viszonyítva	viszonyítva
vizeletben	vizeletben
székletben	székletben
választódik	választódik
Fertőzés	Fertőzés
Fuzidinsav	Fuzidinsav
BUBORÉKFÓLIÁN	buborék+fóliÁ(n)
FELTÜNTETENDŐ	FELTÜNTETENDŐ
Xenical	Xenical
kapszulát	kapszulát
elmondottaknak	elmondottaknak
megfelelően	megfelelően
Patkányokban	Patkányokban
nyulakban	nyulakban
toxikus	toxikus
észleltek	észleltek
embryofoetalis	embryofoetalis
fejlődésre	fejlődésre
állatkísérletekben	állat+kísérlet(ekben)
dopaminerg	dopaminerg
hyperaktivitásnál	hyperaktivitásnál
antagonista	antagonista
hypoaktivitásnál	hypoaktivitásnál
agonista	agonista
hatásúnak	hatásúnak
bizonyult	bizonyult
Kockázatkezelési	kockázat+kezelés|i
rendszer	rendszer
További	További
információk	információk
forgalombahozatali	forgalom|ba+hozatal|i
előkeverékek	elő+keverék(ek)
liposzómás	liposzómás
diszperziós	diszperziós
infúzió	infúzió
készítésére	készítésére
koncentrátumhoz	koncentrátumhoz
Liposzómás	Liposzómás
doxorubicin	doxorubicin
allergiás	allergiás
reakció	reakció
egyetlen	egyetlen
mellékhatás	mellék+hatás
amelyet	amelyet
kalcitoninnal	kalcitoninnal
emlődaganatos	emlő+daganat(os)
módosítást	módosítást
engedélyezték	engedélyezték
egyaránt	egyaránt
megfogva	megfogva
fordítsa	fordítsa
CSOMAGOLÁSON	CSOMAGOLÁSON
induktorok	induktorok
javallott	javallott
enzimindukciós	enzim+indukció|s
potenciálú	potenciálú
alternatív	alternatív
gyógyszereket	gyógy+szer(eket)
választani	választani
vizsgálatokat	vizsgálatokat
havonta	havonta
elvégezzék	elvégezzék
teljesen	teljesen
panaszmentes	panasz+mentes
nagyobb	nagyobb
beállítani	beállítani
patronban	patronban
megmaradt	megmaradt
inzulinmennyiség	inzulin+mennyiség
adagbeállító	adag+beállít|ó
elforgatásakor	elforgatásakor
történik	történik
inzulinbeadás	inzulin+beadás
Szoptatás	Szoptatás
technikai	technikai
utasítások	utasítások
szerint	szerint
nyomógomb	nyomó+gomb
benyomásával	benyomásával
fecskendő	fecskendő
segítségével	segítségével
injekcióhoz	injekcióhoz
Viraferont	Viraferont
fecskendezni	fecskendezni
kockázatokkal	kockázatokkal
alkalmazása?	alkalmazása?
tabletták	tabletták
tárolását	tárolását
pontban	pontban
Gyomor-	Gyomor-
bélrendszer	bél+rendszer
nyelőcső	nyel|ő+cső
nyálkahártyájának	nyálka+hártyÁ(jának)
gyulladása	gyulladása
bélhűdés	bél+hűdés
vérhányás	vér+hányás
amennyiben	amennyiben
elszíneződött	elszíneződött
zavaros	zavaros
szemcsés	szemcsés
elkezdése	elkezdése
transzdermális	transzdermális
hagyományos	hagyományos
doxorubicin-	doxorubicin-
hidroklorid	hidroklorid
készítményekkel	készítményekkel
kölcsönhatásba	kölcsön+hatás(ba)
gyógyszerek	gyógy+szer(ek)
egyidejű	egy+idŐ(jű)
alkalmazásakor	alkalmazásakor
körültekintően	körül+tekint|ő(en)
eljárni	eljárni
variabilitás	variabilitás
optimális	optimális
kezelési	kezelési
egyénre	egyénre
szabott	szabott
titrálással	titrálással
állapítandó	állapítandó
INJEKCIÓS	INJEKCIÓS
OLDÓSZERTARTALMÚ	old|ó+szer+tartalm|ú
INTEGRILIN	INTEGRILIN
Cervarix	Cervarix
felnőtt	felnőtt
tapasztalt	tapasztalt
hatékonyságának	hatékonyságának
vonatkoztatása	vonatkoztatása
serdülőkorúakra	serdül|ő+kor+ú+(akra)
Galaktóz	Galaktóz
intolerancia	intolerancia
előforduló	előforduló
örökletes	örökletes
galaktóz	galaktóz
intoleranciában	intoleranciában
laktáz-	laktáz-
hiányban	hiányban
glükóz-	glükóz-
malabszorpcióban	malabszorpcióban
szedhető	szedhető
Astellas	Astellas
lamivudint	lamivudint
egyidejűleg	egy+idE(jűleg)
alkalmazzák	alkalmazzák
lamivudin	lamivudin
hepatitis	hepatitis
alkalmazásáról	alkalmazásáról
információ	információ
előírásában	elő+írás(ában)
TRITAZIDE	TRITAZIDE
Prevenar	Prevenar
rendellenes	rend+ellenes
májfunkciós	máj+funkció(s)
értékek	értékek
túlnyomó	túl+nyom|ó
normalizálódtak	normalizálódtak
dózismódosítás	dózis+módosítás
dózismódosítást	dózis+módosítás(t)
megszakítását	megszakítását
Prograf	Prograf
ciklosporin	ciklosporin
Advagraf	Advagraf
hatásossága	hatásossága
biztonságossága	biztonságossága
vesetranszplantált	vese+transzplantált
betegen	betegen
összehasonlításra	összehasonlításra
baziliximab	baziliximab
antitest	anti+test
indukcióval	indukcióval
kortikoszteroidokkal	kortikoszteroidokkal
MIRAPEXIN	MIRAPEXIN
oktreotid	oktreotid
lanreotid	lanreotid
csökkentheti	csökkentheti
növelheti	növelheti
inzulinigényt	inzulin+igény(t)
szérumban	szérumban
ellenőrizze	ellenőrizze
Tevagrastim	Tevagrastim
fecskendőben	fecskendőben
alábbiakban	alábbiakban
felsorolt	felsorolt
gyakoriságát	gyakoriságát
egyezmény	egyezmény
határozzák	határozzák
veleszületett	vele+született
protein	protein
CEPROTIN	CEPROTIN
purpura	purpura
fulminans	fulminans
eseténél	eseténél
kumarin-	kumarin-
indukálta	indukálta
bőrnekrózis	bőrnekrózis
konzultáljon	konzultáljon
orvosával	orvosával
terhességet	terhességet
atorvasztatinnal	atorvasztatinnal
Enviage	Enviage
egyensúlyi	egyensúlyi
Effentora	Effentora
nedvességgel	nedvességgel
érintkezve	érintkezve
pezsgési	pezsgési
reakcióval	reakcióval
hatóanyagát	ható+anyag(át)
etoricoxib	etoricoxib
szerzett	szerzett
tapasztalatok	tapasztalatok
Hyperhydrosis	Hyperhydrosis
lábfájás	láb+fájás
gyomorfájás	gyomor+fájás
hasmenés	has+menés
székrekedés	szék+rekedés
Truvada-	Truvada-
vérvizsgálatok	vér+vizsgálat(ok)
hepatitisz	hepatitisz
fertőzésük	fertőzésük
súlyosbodott	súlyosbodott
felfordított	felfordított
üvegben	üvegben
folyadék	folyadék
középső	középső
részéből	részéből
kiszívni	kiszívni
anyagot	anyagot
viszkózus	viszkózus
formájában	formájában
másodpercet	másod+perc(et)
Osigraft?	Osigraft?
follitropin	follitropin
TESAVEL-	TESAVEL-
Vérképzőszervi	Vér+képző+szerv|i
nyirokrendszeri	nyirok+rendszer|i
Nátrium-	Nátrium-
hidroxidot	hidroxidot
sósavat	sósavat
használhatnak	használhatnak
savasság	savasság
beállításához	beállításához
fogamzásgátlók	fogamzás+gátló(k)
AVANDAMET	AVANDAMET
roziglitazon/	roziglitazon/
metformin	metformin
Rapilysin	Rapilysin
Lozartán	Lozartán
lozartán	lozartán
plazma-	plazma-
clearance-	clearance-
hozzávetőleg	hozzá+vet|ő(leg)
metabolitjáé	metabolitjáé
Kimutatták	Kimutatták
kortikoszteroidok	kortikoszteroidok
dózisai	dózisai
csökkentik	csökkentik
takrolimusz	takrolimusz
vérszintjét	vér+szint(jét)
paliperidon	paliperidon
anyatejbe	anya+tej(be)
szoptatott	szoptatott
csecsemőre	csecsemőre
szoptató	szoptató
adagokat	adagokat
Inkompatibilitások	Inkompatibilitások
átmeneti	átmeneti
ischaemiás	ischaemiás
cerebrovaszkuláris	cerebrovaszkuláris
történés	történés
gyógyszermellékhatások	gyógyszer+mellék+hatás(ok)
melyeket	melyeket
sorrendben	sorrendben
gyakorisággal	gyakorisággal
törzskönyvi	törzs+könyv|i
befolyásolhatja	befolyásolhatja
amelyeket	amelyeket
szednie	szednie
üzemeltetéséhez	üzemeltetéséhez
képességekre	képességekre
kifejtett	kifejtett
hatásait	hatásait
ciszteamin	ciszteamin
szemcseppet	szem+csepp(et)
használ	használ
alkalmazását	alkalmazását
folytatni	folytatni
Mycamine	Mycamine
candidiasis	candidiasis
kezelésében	kezelésében
ugyanolyan	ugyanolyan
hatékony	hatékony
összehasonlító	összehasonlító
készítmények	készítmények
vizsgálatokban	vizsgálatokban
azonban	azonban
túlérzékenységi	túl+érzékenység|i
reakciók	reakciók
gyakoriságának	gyakoriságának
növekedését	növekedését
védettség	védettség
kezdete	kezdete
bizonyítottan	bizonyítottan
alapimmunizálás	alap+immunizálás
körülmények	körülmények
észlelhető	észlelhető
Hydrochlorothiazide	Hydrochlorothiazide
Winthrop-	Winthrop-
állapotokat	állapotokat
rendezni	rendezni
Kölcsönzött	Kölcsönzött
munkaerő	munka+erő
ideiglenes	ideiglenes
szolgáltatások	szolgáltatások
SILAPO-	SILAPO-
TÁROLNI?	TÁROLNI?
kezelését	kezelését
személyre	személyre
fájdalmas	fájdalmas
Österreich	Österreich
Austria	Austria
Tipografilor	Tipografilor
Felnőttek	Felnőttek
bevonásával	bevonásával
maximum	maximum
dózisok	dózisok
véletlen	véletlen
mellékhatásokat	mellék+hatás(okat)
Valtropin-	Valtropin-
javallatok	javallatok
szereplő	szereplő
diagnosztizálásában	diagnosztizálásában
kezdeményezze	kezdeményezze
kövesse	kövesse
figyelemmel	figyelemmel
Pradaxa	Pradaxa
vérrögök	vér+rög(ök)
kialakulásának	kialakulásának
megelőzésére	megelőzésére
gyermekemnek	gyermekemnek
granulátumot?	granulátumot?
gyógyszert	gyógy+szer(t)
csatlakoztatása	csatlakoztatása
beállítása	beállítása
kétszeres	kétszeres
kihagyott	kihagyott
pótlására	pótlására
előfordulnak	előfordulnak
javasolhatja	javasolhatja
lefekvéskor	lefekvéskor
gyomorra	gyomorra
STOCRIN-	STOCRIN-
Alsfelder	Alsfelder
Várható	Várható
anyatejjel	anya+tej(jel)
kiválasztódnak	kiválasztódnak
bizonyították	bizonyították
bőrreakciók	bőr+reakció(k)
úgymint	úgymint
keményedés	keményedés
gyógyulás	gyógyulás
hegesedés	hegesedés
hólyagok	hólyagok
felléphetnek	felléphetnek
perccel	perccel
étkezés	étkezés
Subcutan	Subcutan
intramuscularis	intramuscularis
intrvénás	intrvénás
alkalmazás	alkalmazás
tolerálható	tolerálható
tanulmányok	tanulmányok
alkalmazást	alkalmazást
duzzanat	duzzanat
megfigyelhető	megfigyelhető
kevesebb	kevesebb
Kizárólag	Kizárólag
állatorvosi	állat+orvos|i
rendelvényre	rendelvényre
Azonban	Azonban
vizsgálatba	vizsgálatba
belépéskor	belépéskor
aszpartámot	aszpartámot
édesítőszerként	édes|ítő+szer(ként)
időtartama	idő+tartam(a)
Ismételt	Ismételt
virológiai	virológiai
előrejelezhetősége	előre+jelez(hetősége)
Elméletileg	Elméletileg
túladagolás	túl+adagol(ás)
gátlást	gátlást
okozhat	okozhat
ellenére	ellenére
elővigyázatosság	elő+vigyázat|osság
hányinger/	hány+inger/
dsypepsia/	dsypepsia/
gyomorégés	gyomor+égés
Rasilez	Rasilez
Arzneimittel	Arzneimittel
helyzetben	helyzetben
Egerekben	Egerekben
mindössze	mind+össze
májadenomák	májadenomák
carcinomák	carcinomák
incidenciája	incidenciája
azokban	azokban
adaggal	adaggal
amelyeknél	amelyeknél
történt	történt
Catalent	Catalent
Packaging	Packaging
Headway	Headway
Northamptonshire	Northamptonshire
Britannia	Britannia
Alapimmunizálás	alap+immunizálás
Retacritval	Retacritval
bizottság	bizottság
következtetése	következtetése
Atripla	Atripla
kényelmes	kényelmes
"naponta	"naponta
tabletta"	tabletta"
formájú	formájú
alacsony	alacsony
vírusterhelést	vírus+terhelés(t)
fenntartani	fenntartani
elegendő	elegendő
betegekkel	betegekkel
előzőleg	előzőleg
részesültek	részesültek
kezelésben	kezelésben
Myozyme	Myozyme
pótolja	pótolja
glukozidáz	glukozidáz
elnevezésű	elnevezésű
enzimet	enzimet
betegségben	betegségben
szenvedőknél	szenvedőknél
hiányzik	hiányzik
Világossárga	világos+sárga
bikonvex	bikonvex
oldalon	oldalon
másikon	másikon
felirattal	felirattal
kesztyűt	kesztyűt
széleskarimájú	széles+karimÁ(jú)
kalapot	kalapot
kölcsönhatás	kölcsön+hatás
epoetin	epoetin
hematológiai	hematológiai
differenciáció	differenciáció
biopsziás	biopsziás
proliferációja	proliferációja
Company	Company
Operations	Operations
Fleming	Fleming
Liverpool	Liverpool
Szcintillációs	Szcintillációs
Gastrointes	Gastrointes
tinalis	tinalis
Sanofi-	Sanofi-
Aventis	Aventis
inzulinnal	inzulinnal
keverhető	keverhető
inzulinpumpákhoz	inzulin+pumpÁ(khoz)
speciális	speciális
inzulinokat	inzulinokat
tünetei	tünetei
pruritus	pruritus
pigmentációja	pigmentációja
izzadás	izzadás
rheumatoid	rheumatoid
arthritis	arthritis
psoriatica	psoriatica
szakorvosnak	szak+orvos(nak)
megkezdenie	megkezdenie
ellenőriznie	ellenőriznie
Copalia-	Copalia-
mellett	mellett
hipotónia	hipotónia
beteget	beteget
hanyatt	hanyatt
fektetni	fektetni
fiziológiás	fiziológiás
sóoldatot	só+oldat(ot)
tyúktojásban	tyúk+tojás(ban)
tenyésztett	tenyésztett
formaldehiddel	formaldehiddel
inaktivált	inaktivált
influenzavírus	influenza+vírus
felszínéről	felszínéről
távolítják	távolítják
életkor	életkor
gyermekek	gyermekek
szedhetik	szedhetik
Norvirt	Norvirt
AMMONAPS	AMMONAPS
ammóniatartalmának	ammónia+tartalmá(nak)
emelkedését	emelkedését
meggátolni	meggátolni
alkalmas	alkalmas
beavatkozást	beavatkozást
igénylő	igénylő
állapot	állapot
helyettesítő	helyettesítő
filgrasztim	filgrasztim
ugyanúgy	ugyan+úgy
természetes	természetes
termelődő	termelődő
csontvelőt	csont+velő(t)
fehérvérsejt	fehér+vér+sejt
termelésére	termelésére
serkenti	serkenti
INCRELEX	INCRELEX
Mecaszermin	Mecaszermin
levodopa	levodopa
karbidopa	karbidopa
entakapon	entakapon
Bizonyosodjunk	Bizonyosodjunk
medikált	medikált
eledelt	eledelt
elfogyasztotta-	elfogyasztotta-
mikrogramm	mikro+gramm
Hyperbilirubinaemia	Hyperbilirubinaemia
gyakrabban	gyakrabban
jelentkezett	jelentkezett
meghaladó	meghaladó
rifabutin	rifabutin
tipranavir	tipranavir
értékét	értékét
gyógyszermellékhatást	gyógyszer+mellék+hatás(t)
biztonságossági	biztonságossági
adatbázisba	adat+bázis(ba)
ezeknek	ezeknek
reakcióknak	reakcióknak
megbízhatóan	megbízhatóan
meghatározni	meghatározni
sejtfelszínről	sejt+felszín(ről)
internalizálódik	internalizálódik
kötődéssel	kötődéssel
pezsgőgranulátum	pezsgő+granulátum
feloldása	feloldása
vakcina-	vakcina-
szuszpenzió	szuszpenzió
hozzáadása	hozzáadása
ivóvizet	ivó+vIz(et)
készítsen	készítsen
amennyi	amennyi
folyadékigény	folyadék+igény
kielégítéséhez	kielégítéséhez
szereléken	szereléken
hatásosság	hatásosság
mércéje	mércéje
elteltével	elteltével
reagáltak	reagáltak
kezelésre	kezelésre
pontszámai	pont+szám(ai)
javultak	javultak
értékelte	értékelte
benyújtott	benyújtott
megfogalmazási	megfogalmazási
javaslatot	javaslatot
különös	különös
figyelmet	figyelmet
szentelt	szentelt
kérdéseknek	kérdéseknek
Vemhesség	Vemhesség
laktáció	laktáció
pszichiátriai	pszichiátriai
felnőttek	felnőttek
antidepresszánsokat	anti+depresszáns(okat)
vizsgáló	vizsgáló
placebo-	placebo-
kontrollos	kontrollos
metaanalízise	metaanalízise
kimutatta	kimutatta
fiatalabb	fiatalabb
öngyilkos	ön+gyilkos
magatartás	magatartás
kockázata	kockázata
antidepresszánst	antidepresszánst
szedőknél	szedőknél
fokozottabb	fokozottabb
placebót	placebót
foglalja	foglalja
szereket	szereket
óvatosan	óvatosan
Renagel	Renagel
felírásakor	felírásakor
megkezdhető	megkezdhető
Alexion	Alexion
Francja	Francja
ALKALMAZÁSI	ALKALMAZÁSI
ELŐÍRÁS	ELŐÍRÁS
MÓDOSÍTÁSÁNAK	MÓDOSÍTÁSÁNAK
INDOKLÁSA	INDOKLÁSA
Beszélje	Beszélje
egyáltalán	egyáltalán
vezethet-	vezethet-
kezelhet-	kezelhet-
hipoglikémiás	hipoglikémiás
reakciója	reakciója
reakciót	reakciót
nehezen	nehezen
alkalmaz	alkalmaz
amennyire	amennyire
szüksége	szüksége
vércukorszint	vér+cukor+szint
korreláció	korreláció
májbetegség	máj+betegség
súlyossága	súlyossága
vildagliptin-	vildagliptin-
expozíció	expozíció
változásai	változásai
Esetenként	Esetenként
invazív	invazív
endoszkópos	endoszkópos
módszerekkel	módszerekkel
elkülönítő	elkülönítő
diagnózisra	diagnózisra
kizárása	kizárása
érdekében	érdekében
autoimmun	autoimmun
gastritis	gastritis
malignus	malignus
folyamatok	folyamatok
hipoglikémia	hipoglikémia
figyelmeztet	figyelmeztet
jelentkezhetnek	jelentkezhetnek
következ	következ
nyilvánulhatnak	nyilvánulhatnak
szapora	szapora
émelygés	émelygés
látászavarok	látás+zavar(ok)
bágyadtság	bágyadtság
szokatlan	szokatlan
fáradtság	fáradtság
gyengeség	gyengeség
szorongó	szorongó
zavarodottság	zavarodottság
koncentrálási	koncentrálási
nehézség	nehézség
folyamat	folyamat
magasabb	magasabb
következménye	következménye
vérnyomáscsökkentő	vér+nyomás+csökkentő
megkezdésétől	megkezdésétől
számított	számított
javasolta	javasolta
MabCampath-	MabCampath-
kiadását	kiadását
hasznosság	hasznosság
kérdésével	kérdésével
kielégítően	kielégítően
foglalkoztak	foglalkoztak
elfogadta	elfogadta
megfogalmazást	megfogalmazást
véleménye	véleménye
következtetés	következtetés
vonható	vonható
kontrasztanyagként	kontraszt+anyag(ként)
Gadovistot	Gadovistot
Magnevistet	Magnevistet
alkalmazó	alkalmazó
eljárásokat	eljárásokat
veseelváltozások	vese+elváltozás(ok)
jóindulatú	jó+indulat|ú
rosszindulatú	rossz+indulat|ú
jellegének	jellegének
megállapítása	megállapítása
Gadovist	Gadovist
diagnosztikai	diagnosztikai
hatékonysága	hatékonysága
igazolást	igazolást
illetően	illetően
hozatal	hozatal
spontán	spontán
jelentések	jelentések
benyújtásának	benyújtásának
tisztázását	tisztázását
szakaszban	szakaszban
használat	használat
jelentkező	jelentkező
mellékhatásokra	mellék+hatás(okra)
valamennyi	valamennyi
táblázatban	táblázatban
alkalmazandó	alkalmazandó
felülvizsgált	felül+vizsgál|t
kifejezések	kifejezések
listájára	listájára
deferipront	deferipront
testtömegkilogramm	test+tömeg+kilogramm
arányban	arányban
adagolják	adagolják
orálisan	orálisan
alkalommal	alkalommal
testtömegkilogrammnak	test+tömeg+kilogramm(nak)
tablettára	tablettára
kerekítve	kerekítve
számítandó	számítandó
serdülőkorúak	serdül|ő+kor|ú(ak)
bármelyik	bármelyik
gyógyszerformát	gyógyszer+formÁ(t)
NovoMix	NovoMix
szennyvízzel	szenny+víz(zel)
háztartási	háztartási
hulladékkal	hulladékkal
megsemmisíteni	megsemmisíteni
pivotális	pivotális
kettős-	kettős-
abbahagyták	abbahagyták
Humira-	Humira-
betegcsoportban	beteg+csoport(ban)
Azoknál	Azoknál
előzetesen	előzetesen
mellitus-	mellitus-
diagnosztizáltak	diagnosztizáltak
szomatropin-	szomatropin-
megkezdésekor	megkezdésekor
antidiabetikus	anti+diabetikus
módosítása	módosítása
EXUBERA	EXUBERA
március	március
legutolsó	legutolsó
Zidovudinnal	Zidovudinnal
expozíciója	expozíciója
emelkedik	emelkedik
csúcskoncentráció	csúcs+koncentráció
Anaemia	Anaemia
Thrombocytopenia	Thrombocytopenia
Immeuble	Immeuble
Général	Général
Puteaux	Puteaux
Franciaország	Francia+ország
tolerálja	tolerálja
sebességét	sebességét
fokozatosan	fokozatosan
színének	színének
elváltozása	elváltozása
írisszel	írisszel
rendelkező	rendelkező
tapasztalható	tapasztalható
kékesbarna	kék|es+barna
szürkésbarna	szürkÉ|s+barna
sárgásbarna	sárgÁ|s+barna
zöldesbarna	zöld|es+barna
szemszín	szem+szín
jelenséget	jelenséget
megfigyelték	megfigyelték
leggyakoribb	leggyakoribb
pyrexia	pyrexia
Gyrablock	Gyrablock
Nyulakon	Nyulakon
szisztémás	szisztémás
szeresének	szeresének
befejezetlen	befejezetlen
csontosodás	csontosodás
incidenciáját	incidenciáját
párhuzamosan	párhuzamosan
megfigyelt	megfigyelt
állatokkal	állatokkal
IMPRIDA-	IMPRIDA-
Felszívódás	Felszívódás
specifikus	specifikus
plazmaészterázok	plazmaészterázok
végrehajtott	végre+hajt|ott
hidrolízis	hidrolízis
fezoterodin	fezoterodin
mutatható	mutatható
plazmában	plazmában
pozitív	pozitív
szakvéleményt	szak+vélemény(t)
amelyben	amelyben
Risperdal	Risperdal
előírásának	elő+írás(ának)
címkeszövegének	címke+szöveg(ének)
betegtájékoztatójának	beteg+tájékoztató(jának)
harmonizálását	harmonizálását
RIBAVIRIN	RIBAVIRIN
legtöbb	legtöbb
hónapja	hónapja
Mindazonáltal	Mindazonáltal
figyelembe	figyelembe
vesszük	vesszük
biztonsági	biztonsági
profilt	profilt
megnövekedett	megnövekedett
kockázati	kockázati
előfordulást	előfordulást
moxifloxacin	moxifloxacin
kezdeti	kezdeti
antibakteriális	anti+bakteriális
célszerűnek	cél+szerű(nek)
szervezete	szervezete
egyértelműen	egy+értelmű(en)
reagált	reagált
vérszegénység	vér+szegénység
gyógyszerekre	gyógy+szer(ekre)
Nasopharyngitis	Nasopharyngitis
nátrium-	nátrium-
gyógyszerrel	gyógy+szer(rel)
visszaélés	visszaélés
lehetősége	lehetősége
farmakokinetikájáról	farmakokinetikájáról
végeztek	végeztek
májkárosodott	máj+kár|os(odott)
májkárosodás	máj+kár|os(odás)
tanácsos	tanácsos
Stalevo	Stalevo
elővigyázatosságot	elővigyázatosságot
tanúsítani	tanúsítani
kizárólag	kizárólag
meddőséget	meddőséget
kórfolyamatokat	kór+folyamat(okat)
kezelésükben	kezelésükben
orvosok	orvosok
alkalmazhatják	alkalmazhatják
Emselex	Emselex
amelyek	amelyek
mindenkinél	mindenkinél
jelentkeznek	jelentkeznek
IntronA	IntronA
adagjának	adagjának
kimérése	kimérése
Távolítsa	Távolítsa
védőkupakját	védő+kupak(ját)
Hígítás	Hígítás
buszulfán/	buszulfán/
oldatot	oldatot
Business	Business
vizsgálatban	vizsgálatban
populációjához	populációjához
asztmás	asztmás
betegben	betegben
hatásosságát	hatásosságát
biztonságosságát	biztonságosságát
szoptatás	szoptatás
befolyásolta	befolyásolta
duloxetin	duloxetin
patkány	patkány
QI06AH08	QI06AH08
transzfer-	transzfer-
szorosan	szorosan
csavarja	csavarja
fecskendőre	fecskendőre
hatásmódja	hatás+mód(ja)
Holland	Holland
Dicuralra	Dicuralra
Rágcsálókkal	Rágcsálókkal
elvégzett	elvégzett
hatóanyag	hat|ó+anyag
fajspecifikus	faj+specifikus
vetélést	vetélést
okozott	okozott
eredményei	eredményei
mutatják	mutatják
baktériumok	baktériumok
bizonyos	bizonyos
csoportjainál	csoportjainál
hatékonyan	hatékonyan
gátolja	gátolja
szaporodását	szaporodását
köhögés	köhögés
hosszabb	hosszabb
tarthat	tarthat
celekoxib-	celekoxib-
szakítani	szakítani
nyálkahártya-	nyálka+hártya+
elváltozások	elváltozások
túlérzékenység	túl+érzékenység
jelének	jelének
megjelenésekor	megjelenésekor
Pasteur	Pasteur
Belgard	Belgard
Tallaght	Tallaght
Ireland	Ireland
Revlimid-	Revlimid-
eredmények	eredmények
kedvezőbbek	kedvezőbbek
lopinavir/	lopinavir/
ritonavirra	ritonavirra
részleteket	részleteket
Neurotoxicitás	Neurotoxicitás
ciszplatin	ciszplatin
dózismódosítását	dózis+módosítás(át)
mutatja	mutatja
KÖZVETLEN	KÖZVETLEN
cetirizin	cetirizin
plazmafehérjékhez	plazma+fehérjÉ(khez)
kötődése	kötődése
gyógyszertárát	gyógy+szer+tár(át)
TESAVEL	TESAVEL
Puregon	Puregon
hatásosnak	hatásosnak
Bevezetés	Bevezetés
Poliszorbát	Poliszorbát
foszfát	foszfát
dibázis	dibázis
heptahidrát	heptahidrát
monobázis	monobázis
monohidrát	monohidrát
Injekcióhoz	Injekcióhoz
aminotranszferáz	aminotranszferáz
emelkedése	emelkedése
folytatásával	folytatásával
reverzibilissé	reverzibilissé
ezekben	ezekben
vérlemezkeszámot	vér+lemezke+szám(ot)
hetente	hetente
Nycomed	Nycomed
Oranienburg	Oranienburg
Lehnitzstrasse	Lehnitzstrasse
Németország	Német+ország
Általában	Általában
testtömegű	test+tömeg|ű
igényelnek	igényelnek
feletti	feletti
Olanzapin	Olanzapin
mindkét	mindkét
ProMeris	ProMeris
méretben	méretben
kapható	kapható
szervek	szervek
normálisan	normálisan
egymással	egymással
összeköttetésben	összeköttetésben
szövetek	szövetek
kezelőorvos	kezel|ő+orvos
súlyosnak	súlyosnak
tesztoszteron	tesztoszteron
véráramban	vér+áram(ban)
keringő	keringő
elsődleges	elsődleges
androgén	androgén
természetesen	természetesen
petefészkek	pete+fészk(ek)
mellékvese	mellék+vese
termelt	termelt
szteroid	szteroid
abbahagyása	abbahagyása
alakult	alakult
meghatározott	meghatározott
hullámhosszú	hullám+hossz(ú)
fénnyel	fénnyel
világítják	világítják
tumorban	tumorban
intenzív	intenzív
egészséges	egészséges
agyszövet	agy+szövet
látszik	látszik
címkéjén	címkéjén
felhasználni	felhasználni
kivételes	kivételes
kezeléssel	kezeléssel
összefüggő	összefüggő
placebóhoz	placebóhoz
incidenciával	incidenciával
fordultak	fordultak
elhízott	elhízott
diabeteses	diabeteses
betegeken	betegeken
peginterferon	peginterferon
használatra	használatra
adagolása	adagolása
clearance	clearance
Emellett	Emellett
eltéréseket	eltéréseket
észlelhet	észlelhet
vizeletvizsgálati	vizelet+vizsgálat|i
eredményeiben	eredményeiben
Gottlieb-	Gottlieb-
Daimler-	Daimler-
SPRYCEL	SPRYCEL
Atriance	Atriance
Luveris-	Luveris-
Metabolitjai	Metabolitjai
dezmetil	dezmetil
hidroximetil	hidroximetil
származékai	származékai
citokróm-	citokróm-
közremű	közremű
ködésével	ködésével
szignifikánsan	szignifikánsan
farmakológiai	farmakológiai
hatásúak	hatásúak
olanzapin	olanzapin
Tüdőszövődmények	tüdő+szövődmény(ek)
Vastúlterhelt	vas+túlterhel|t
thalassaemiás	thalassaemiás
émelygést	émelygést
hasmenést	has+menés(t)
megjegyzések	megjegyzések
Kövesse	Kövesse
orvosának	orvosának
higiénikus	higiénikus
beadási	beadási
módjára	módjára
utasításait	utasításait
próbálja	próbálja
inzulint	inzulint
adagológomb	adagol|ó+gomb
elfordításával	elfordításával
Folytassa	Folytassa
dózissal	dózissal
amelyekben	amelyekben
Galvus-	Galvus-
kiegészítőként	kiegészítőként
Icandra	Icandra
javallatú	javallatú
alátámasztására	alátámasztására
felhasználták	felhasználták
BETEGTÁJÉKOZTATÓ	beteg+tájékoztat|Ó
Zevalin	Zevalin
gyógyszerekkel	gyógy+szer(ekkel)
kölcsönhatásokat	kölcsön+hatás(okat)
részletesen	részletesen
hozatala	hozatala
izolált	izolált
előfordulásáról	előfordulásáról
különösen	különösen
gyógyszerkészítmények	gyógy+szer+készítmény(ek)
lecsökkentését	lecsökkentését
beszüntetését	beszüntetését
Kombinált	Kombinált
ribavirin	ribavirin
kapszulával	kapszulával
mikrogramm/	mikrogramm/
dózisban	dózisban
hetenként	hetenként
ViraferonPegt	ViraferonPegt
OptiClik-	OptiClik-
patronokat	patronokat
tervezték	tervezték
lehessen	lehessen
hozzájuk	hozzájuk
FABLYN-	FABLYN-
szoptat	szoptat
kiválasztódhat	kiválasztódhat
angiotenzin-	angiotenzin-
receptor	receptor
valzartánnal	valzartánnal
kombinációban	kombinációban
Sprimeo	Sprimeo
additív	additív
kifejezetten	kifejezetten
hatásának	hatásának
tanulmányozására	tanulmányozására
tervezett	tervezett
társfertőzésben	társ+fertőzés(ben)
kapjanak	kapjanak
genotípus	genotípus
RotaTeqet	RotaTeqet
eltelnie	eltelnie
beszélte	beszélte
Ezekben	Ezekben
legelterjedtebb	legelterjedtebb
rotavírus	rotavírus
szerotípus	szerotípus
szerotípusokat	szerotípusokat
kevésbé	kevésbé
azonosították	azonosították
elhalaszthatja	elhalaszthatja
általános	általános
állapotától	állapotától
függően	függően
vérképe	vérképe
Triatec	Triatec
tabletter	tabletter
Ramipril	Ramipril
Pramace	Pramace
kapslar	kapslar
megbeszélés	megbeszélés
eredményét	eredményét
nemzeti	nemzeti
illetékes	illetékes
hatóságnak	hatóságnak
jóváhagynia	jóváhagynia
tagállamban	tag+állam(ban)
profilaktikus	profilaktikus
csípőtáji	csípő+táj|i
helyreállító	hely(re)+állít|ó
Fejfájás	fej+fájás
beadásának	beadásának
fellépő	fellépő
Adagolás	Adagolás
étvágytalanság	ét+vágytalanság
édeskés	édeskés
lehelet	lehelet
közérzet	köz+érzet
állatokon	állatokon
jelenségek	jelenségek
természetűek	természetűek
interferonnal	interferonnal
megfigyeltek	megfigyeltek
menstruációs	menstruációs
kimaradása	kimaradása
Replagal	Replagal
betegség	betegség
anyagcsere-	anyag+csere-
orvosnak	orvosnak
felügyelnie	felügyelnie
Arthritis	Arthritis
összesített	összesített
követési	követési
analízisének	analízisének
legfontosabb	legfontosabb
hatásossági	hatásossági
eredményeit	eredményeit
ártalmatlansága	ártalmatlansága
igazolt	igazolt
tojásrakás	tojás+rakás
INTRONA	INTRONA
felszívódás	felszívódás
ütemétől	ütemétől
kezdeni	kezdeni
randomizált	randomizált
multinacionális	multinacionális
lamivudin-	lamivudin-
hasonlították	hasonlították
vizsgálati	vizsgálati
krónikus	krónikus
fertőzésben	fertőzésben
betegnél	betegnél
antinukleozid-	antinukleozid-
MELLÉKLET	MELLÉKLET
gondolja	gondolja
szedhet	szedhet
Xeloda-	Xeloda-
magának	magának
orvostól	orvostól
nővértől	nővértől
kiképzést	kiképzést
terápiát	terápiát
fertőzöttek	fertőzöttek
elrendelnie	elrendelnie
Mycamine-	Mycamine-
szirolimuszt	szirolimuszt
nifedipint	nifedipint
itrakonazolt	itrakonazolt
ellenőrizni	ellenőrizni
szirolimusz	szirolimusz
nifedipin	nifedipin
itrakonazol-	itrakonazol-
toxicitást	toxicitást
itrakonazol	itrakonazol
dózisát	dózisát
csökkenteni	csökkenteni
vérének	vérének
nátriumszintje	nátrium+szint(je)
valproinsav	valproinsav
flukonazol	flukonazol
metadon	metadon
zidovudinnal	zidovudinnal
együttadásakor	együtt+adás(akor)
zidovudin	zidovudin
csökken	csökken
prasugrel	prasugrel
láthatóvá	láthatóvá
befejeztéig	befejeztéig
tartályok	tartályok
paclitaxel/	paclitaxel/
cisplatin	cisplatin
lokálisan	lokálisan
előrehaladott	előre+halad|ott
metasztatikus	metasztatikus
kisejtes	kisejtes
tüdőcarcinomában	tüdőcarcinomában
kontrolllált	kontrolllált
bizonyítja	bizonyítja
venlafaxint	venlafaxint
kapszulák	kapszulák
szferoidokat	szferoidokat
tartalmaznak	tartalmaznak
amelyekből	amelyekből
szabadul	szabadul
tápcsatornába	táp+csatornÁ(ba)
túladagolásának	túl+adagolás(ának)
hypotonia	hypotonia
keringési	keringési
elektrolit	elektrolit
veseelégtelenség	vese+elégtelenség
hyperventilláció	hyperventilláció
palpitáció	palpitáció
bradycardia	bradycardia
Soliris-	Soliris-
antikoaguláns	antikoaguláns
Különleges	Különleges
etanercepttel	etanercepttel
szérumában	szérumában
etanercept	etanercept
antitesteket	anti+test(eket)
találtak	találtak
intrathecalis	intrathecalis
zikonotid	zikonotid
egyértelmű	egy+értelEm|ű
Autoinjektor	Autoinjektor
használatával	használatával
csökkenthető	csökkenthető
előfordulása	elő+fordulás(a)
bipoláris	bipoláris
affektív	affektív
típusában	típusában
Trevaclynra	Trevaclynra
Izomfájdalom	izom+fájdalom
ízületifájdalom	ízület|i+fájdalom
Allergiás	Allergiás
reakciókról	reakciókról
beszámoltak	beszámoltak
sokkhoz	sokkhoz
vezettek	vezettek
tablettákat	tablettákat
egészben	egészben
mennyiségű	mennyiségű
folyadékkal	folyadékkal
lenyelni	lenyelni
gátlását	gátlását
Mixtard?	Mixtard?
Védőlap	véd|ő+lap
potenciálisan	potenciálisan
elhúzódó	elhúzódó
immunszuppressziót	immunszuppressziót
okozhatnak	okozhatnak
adagolásuk	adagolásuk
megszüntetése	megszüntetése
tenofovir	tenofovir
elsősorban	első+sor(ban)
távozik	távozik
szervezetből	szervezetből
filtráció	filtráció
tubuláris	tubuláris
transzporter	transzporter
körülbelül	körül+belül
változatlan	változatlan
formában	formában
vizelettel	vizelettel
Temodal	Temodal
dazatinib	dazatinib
metabolitjai	metabolitjai
csekély	csekély
ürülnek	ürülnek
veséken	veséken
bármilyen	bármilyen
változást	változást
küllemén	küllemén
gyógyszerésszel	gyógy+szerész(szel)
GYÁRTÓJA/	GYÁRTÓJA/
GYÁRTÓI	GYÁRTÓI
GYÁRTÁSI	GYÁRTÁSI
TÉTELEK	TÉTELEK
VÉGFELSZABADÍTÁSÁÉRT	vég+felszabadítás(áért)
FELELŐS	FELELŐS
tárolási	tárolási
előírások	elő+írás(ok)
Segédanyagok	segéd+anyag(ok)
felsorolása	felsorolása
HASZNÁLATI	HASZNÁLATI
UTASÍTÁS	UTASÍTÁS
tőgyinfúzió	tőgy+infúzió
szarvasmarhának	szarvas+marhÁ(nak)
Ezenkívül	Ezenkívül
petefészek-	pete+fészek-
daganat	daganat
használatos	használatos
jutassa	jutassa
CYP3A4-	CYP3A4-
inhibitorok	inhibitorok
proteázgátlók	proteázgátlók
hatások	hatások
várhatóak	várhatóak
hasonlóképpen	hasonlóképpen
csökkentése	csökkentése
váltott	váltott
Viraferon	Viraferon
Macugen	Macugen
alkalmazásához	alkalmazásához
társuló	társuló
kockázatot	kockázatot
minimalizálni?	minimalizálni?
hosszúkás	hosszúkás
törésvonallal	törés+vonal(lal)
óvatossággal	óvatossággal
skandináv	skandináv
eredetű	eredetű
fajtáknál	fajtáknál
használjuk	használjuk
Econort	Econort
Szüksége	Szüksége
Semmisítse	Semmisítse
toldalék	toldalék
eszközt	eszközt
Figyelembe	Figyelembe
fejlődésére	fejlődésére
fogamzóképes	fogamzó+képes
fogamzásgátlást	fogamzás+gátlás(t)
alkalmazniuk	alkalmazniuk
emtricitabin-	emtricitabin-
húgyúti	húgyúti
Növekedési	Növekedési
elégtelen	elégtelen
termelése	termelése
növekedési	növekedési
Levemir	Levemir
InnoLet	InnoLet
tartalékként	tartalékként
magánál	magánál
hűtőszekrényben	hűt|ő+szekrény(ben)
tárolni	tárolni
terminális	terminális
felezési	felezési
jelentősen	jelentősen
változott	változott
áttöréses	áttöréses
időpontban	idő+pont(ban)
Kepivance	Kepivance
palifermin	palifermin
Intrinsa	Intrinsa
Közösségek	Közösségek
tisztviselőinek	tiszt+visel|ő(inek)
személyzeti	személyzeti
szabályzata	szabályzata
melléklete	melléklete
információért	információért
előírást	elő+írás(t)
hypersomnia	hypersomnia
letargia	letargia
figyelemzavar	figyelem+zavar
memóriazavar	memória+zavar
dysgeusia	dysgeusia
egyensúlyzavarok	egyensúly+zavar(ok)
látászavar	látás+zavar
gyógyszernek	gyógy+szer(nek)
Seretide	Seretide
Diskusnak	Diskusnak
lehetnek	lehetnek
mellékhatásai	mellék+hatás(ai)
atazanavir	atazanavir
monoterápiás	monoterápiás
intervallum	intervallum
úgynevezett	úgynevezett
citotoxikus	citotoxikus
csoportjába	csoportjába
tartozik	tartozik
FORSTEO	FORSTEO
mikroliter	mikroliter
tollban	tollban
Clopidogrel	Clopidogrel
összetevőiről	összetevőiről
laktózt	laktózt
hidrogénezett	hidrogénezett
ricinusolajat	ricinus+olaj(at)
adagjával	adagjával
tünetekről	tünetekről
cserélni	cserélni
szedése	szedése
vérzési	vérzési
kockázattal	kockázattal
ínyvérzés	íny+vérzés
Articularis	Articularis
tolerálhatóság	tolerálhatóság
kérdőívben	kérdő+ív(ben)
jegyezték	jegyezték
résztvevőknek	rész(t)+vevő(knek)
kellett	kellett
kitölteniük	kitölteniük
Luxemburgi	Luxemburgi
Fordítóközpont	fordít|ó+központ
szitagliptin	szitagliptin
mellékhatásokról	mellék+hatás(okról)
számolt	számolt
izommerevség	izom+merevség
vállalat	vállalat
továbbá	továbbá
dobozokat	dobozokat
biztosítani	biztosítani
amelyeken	amelyeken
illusztrációk	illusztrációk
használni	használni
Hatáserősség	hatás+erősség
nedvességtől	nedvességtől
arcduzzanat	arc+duzzanat
elrendezésben	elrendezésben
elrendezésű	elrendezésű
adagolási	adagolási
időszak	időszak
követte	követte
bromidot	bromidot
lehetett	lehetett
időszakonként	idő+szak(onként)
adagban	adagban
Hollands	Hollands
Haverhill	Haverhill
Suffolk	Suffolk
Egyesült	Egyesült
Királyság	Királyság
ViraferonPeg?	ViraferonPeg?
kullancsot	kullancsot
pusztította	pusztította
határozza	határozza
injekcióra	injekcióra
blokkolja	blokkolja
adrenerg	adrenerg
receptorokat	receptorokat
hisztaminerg	hisztaminerg
SZÖVEGE	SZÖVEGE
Silgard	Silgard
szuszpenziós	szuszpenziós
tűvédővel	tű+véd|ő(vel)
Baraclude?	Baraclude?
dózisra	dózisra
szükségük	szükségük
férfiaknak	férfiaknak
érzékenység	érzékenység
sanofi-	sanofi-
aventis	aventis
Zikonotiddal	Zikonotiddal
észlelhetők	észlelhetők
kognitív	kognitív
neuropszichiátriai	neuropszichiátriai
zavartság	zavartság
éberségre	éberségre
gépjárművezetés	gép+jármű+vezetés
OLANZAPIN	OLANZAPIN
Apidra-	Apidra-
dezirudin	dezirudin
szabadon	szabadon
alvadékhoz	alvadékhoz
thrombin	thrombin
szelektív	szelektív
inhibitora	inhibitora
Abraxane	Abraxane
sejtekre	sejtekre
vérsejtekre	vér+sejt(ekre)
idegsejtekre	ideg+sejt(ekre)
szérumkoncentrációk	szérum+koncentráció(k)
hónapos	hónapos
gyermeknél	gyermeknél
ugyanabban	ugyanabban
tartományban	tartományban
idősebb	idősebb
gyermekeknél	gyermekeknél
némelyik	némelyik
valószínűleg	valószínűleg
előfordulhatnak	előfordulhatnak
szintek	szintek
függőség	függőség
nagyságának	nagyságának
időtartamának	idő+tartam(ának)
emelésével	emelésével
kórelőzményében	kór+előzmény(ében)
alkohol	alkohol
gyógyszerfüggőség	gyógyszer+függőség
szerepel	szerepel
hatékonyság	hatékonyság
tüneteik	tüneteik
pontszáma	pont+szám(a)
Kaposi-	Kaposi-
szarkóma	szarkóma
bleomicin/	bleomicin/
vinkrisztin	vinkrisztin
referencia	referencia
protokollal	protokollal
összevető	összevető
Caelyxszel	Caelyxszel
regisztráltak	regisztráltak
opportunista	opportunista
fertőzéseket	fertőzéseket
dózisfüggő	dózis+függ|ő
celekoxib	celekoxib
Janssen-	Janssen-
International	International
Turnhoutseweg	Turnhoutseweg
Belgium	Belgium
Panretin?	Panretin?
Latvija	Latvija
kockázatcsökkenést	kockázat+csökkenés(t)
összetett	összetett
végpontot	vég+pont(ot)
tekintetében	tekintetében
Kereskedel	Kereskedel
Antimycobacterialis	Antimycobacterialis
Preotact	Preotact
újonnan	újonnan
csigolyatörések	csigolya+törés(ek)
hónapra	hónapra
betegekhez	betegekhez
TERÁPIÁS	TERÁPIÁS
CSOMAGRA	CSOMAGRA
VONATKOZIK	VONATKOZIK
Közbülső	Közbülső
ételekkel	ételekkel
italokkal	italokkal
befolyásolják	befolyásolják
temszirolimusszal	temszirolimusszal
foszfolipidózis	foszfolipidózis
temszirolimusz	temszirolimusz
együttadása	együtt+adás(a)
amphiphilikus	amphiphilikus
hatóanyagokkal	hat|ó+anyag(okkal)
amiodaron	amiodaron
sztatinok	sztatinok
megnövelheti	megnövelheti
pulmonáris	pulmonáris
kockázatát	kockázatát
csökkenését	csökkenését
CIPROBAY	CIPROBAY
hyperkalaemiát	hyperkalaemiát
vizsgálata	vizsgálata
szarvasmarha	szarvas+marha
MENITORIX-	MENITORIX-
ellenőrzi	ellenőrzi
kialakulását	kialakulását
hereelégtelenségben	here+elégtelenség(ben)
Nederland	Nederland
Servier	Servier
Rebetol	Rebetol
interferon	interferon
kombinációja	kombinációja
következőket	következőket
okozhatja	okozhatja
azonosítottak	azonosítottak
metabolitokat	metabolitokat
aktivitás	aktivitás
szubsztitúciós	szubsztitúciós
állapotokhoz	állapotokhoz
CYMBALTA-	CYMBALTA-
alkalmaznak	alkalmaznak
társulhat	társulhat
öngyilkossággal	ön+gyilkosság(gal)
befecskendezésnek	befecskendezésnek
szubkután	szubkután
injekciónak	injekciónak
nevezik	nevezik
Mixtard	Mixtard
NovoLet	NovoLet
betegeknek	betegeknek
koleszterincsökkentő	koleszterin+csökkent|ő
megkezdeniük	megkezdeniük
folytatniuk	folytatniuk
szakaszból	szakaszból
Kezdeti	Kezdeti
ekulizumab	ekulizumab
hetében	hetében
Fenntartó	fenn+tart|ó
pramipexol	pramipexol
terhelésnek	terhelésnek
állapotát	állapotát
követni	követni
laboratóriumi	laboratóriumi
figyelmesen	figyelmesen
utasításokat	utasításokat
koraszülötteknél	kora+szülött(eknél)
NeoRecormon	NeoRecormon
transzfúziót	transzfúziót
Băneasa	Băneasa
MAGUNKNAK	MAGUNKNAK
PEGASYS	PEGASYS
INJEKCIÓT?	INJEKCIÓT?
PORCILIS	PORCILIS
PORCOLI	PORCOLI
DILUVAC	DILUVAC
egység/	egység/
Glargin	Glargin
CellCepttel	CellCepttel
legsúlyosabb	legsúlyosabb
kockázat	kockázat
rákbetegség	rák+betegség
lymphoma	lymphoma
hozatalát?	hozatalát?
Sikertelen	Sikertelen
használó	használó
Hidroklorotiazid	Hidroklorotiazid
monoterápia	mono+terápia
ismeretlen	ismeretlen
gyakoriságú	gyakoriságú
észlelték	észlelték
PREZISTA	PREZISTA
ritonavir	ritonavir
háromhetes	három+hÉt|es
kezelésből	kezelésből
hathetes	hat+hÉt|es
kezelésmentes	kezelés+mentes
tartályba	tartályba
vildagliptin	vildagliptin
metabolikus	metabolikus
várhatóan	várhatóan
inhibitor	inhibitor
induktor	induktor
palivizumab	palivizumab
feloldást	feloldást
elkészítéséhez	elkészítéséhez
módosítására	módosítására
középsúlyos	közép+súly|os
májbetegségben	máj+betegség(ben)
kattanó	kattanó
hallani	hallani
inhalációs	inhalációs
készülék	készülék
nyújtva	nyújtva
testsúlytól	test+súly(tól)
Eloszlás	Eloszlás
montelukaszt	montelukaszt
kötődik	kötődik
Felnőtteknek	Felnőtteknek
TORISEL	TORISEL
gyógyszerré	gyógyszerré
minősítésével	minősítésével
dokumentáció	dokumentáció
elolvasható	elolvasható
felnőttekben	felnőttekben
szedtek	szedtek
személyek	személyek
megerősítették	megerősítették
faltkartonon	faltkartonon
Braille	Braille
írással	írással
tapintható	tapintható
olvasható	olvasható
ÁLTALÁNOS	ÁLTALÁNOS
BESOROLÁSA	BESOROLÁSA
RENDELHETŐSÉG	RENDELHETŐSÉG
SZEMPONTJÁBÓL	SZEMPONTJÁBÓL
állapota	állapota
lehetővé	lehetővé
intravénásan	intravénásan
elkezdeni	elkezdeni
folyamatos	folyamatos
bekövetkezhet	bekövetkezhet
sejtfelszíni	sejt+felszín|i
kötődésen	kötődésen
endocytosis	endocytosis
Fertavidot	Fertavidot
Viracept	Viracept
antivirális	antivirális
hatásosabbnak	hatásosabbnak
összehasonlítás	összehasonlítás
alapját	alapját
gyógyszereknél	gyógyszereknél
dugattyúját	dugattyúját
ezáltal	ezáltal
feltöltődjön	feltöltődjön
holttere	holt+tÉr(e)
Brachyspira	Brachyspira
hyodysenteriae	hyodysenteriae
sertésdizentéria	sertés+dizentéria
állományokban	állományokban
betegséget	betegséget
diagnosztizálták	diagnosztizálták
Csecsemőknél	Csecsemőknél
serdülőknél	serdülőknél
nasopharyngitis	nasopharyngitis
influenza	influenza
felsőlégúti	felső+légút|i
megfelel	megfelel
beállítás	beállítás
csökkenés	csökkenés
kísérték	kísérték
hipotenziós	hipotenziós
Abseamed	Abseamed
Pravasztatin/	Pravasztatin/
Emtricitabin	Emtricitabin
Tenofovir-	Tenofovir-
dizoproxil	dizoproxil
fumarát	fumarát
Neoclaritynt	Neoclaritynt
Neoclarityn	Neoclarityn
belsőleges	belsőleges
amennyit	amennyit
bizsergő	bizsergő
légszomj	lég+szomj
viszketés	viszketés
hajhullás	haj+hullás
reszketés	reszketés
ízérzés	ízérzés
megváltozása	megváltozása
problémák	problémák
fordulnak	fordulnak
akiknek	akiknek
valamilyen	valamilyen
pszichés	pszichés
betegségük	betegségük
november	november
Cyanokitre	Cyanokitre
VIRBAGEN	VIRBAGEN
kutyáknak	kutyáknak
macskáknak	macskáknak
eredeti	eredeti
csomagolásban	csomagolásban
fénytől	fénytől
tartandó	tartandó
Paroxetine	Paroxetine
kezdhető	kezdhető
gyógyul	gyógyul
előzőekben	előzőekben
Avastin	Avastin
hónapról	hónapról
hosszabbította	hosszabbította
Celekoxib-	Celekoxib-
szubsztrát	szubsztrát
dextrametorfán	dextrametorfán
Indokolható	Indokolható
kérelmező	kérelmező
érvelés	érvelés
készítményeket	készítményeket
kontrollként	kontrollként
alkalmazta	alkalmazta
Feltétlenül	Feltétlenül
Betegtájékoztatóját	beteg+tájékoztató(ját)
mielőtt	mielőtt
elkezdi	elkezdi
Rebetollal	Rebetollal
adagolástól	adagolástól
OPATANOL	OPATANOL
ambriszentán	ambriszentán
kiválasztódását	kiválasztódását
anakinra	anakinra
meggátolja	meggátolja
válaszokat	válaszokat
prosztagladin	prosztagladin
indukcióját	indukcióját
synovialis	synovialis
fibroblastok	fibroblastok
chondrocyták	chondrocyták
kollagenáztermelést	kollagenáz+termelés(t)
semmilyen	semmilyen
eseményt	eseményt
Gyűjtse	Gyűjtse
helyezze	helyezze
felületre	felületre
eszközöket	eszközöket
Comtess	Comtess
számára	számára
biztonságosságra	biztonságosságra
hatásosságra	hatásosságra
gemcitabint	gemcitabint
thrombocyta	thrombocyta
leukocyta	leukocyta
granulocytaszámot	granulocytaszámot
ujjainak	ujjainak
zsibbadása	zsibbadása
homályos	homályos
egységcsomagban	egység+csomag(ban)
porüveg	porüveg
egységeket	egységeket
feltüntető	feltüntető
osztásokkal	osztásokkal
eldobható	eldobható
Csökkenti	Csökkenti
transzfúzió	transzfúzió
koraszülött	kor|a+szülött
csecsemőknél	csecsemőknél
kemoterápiában	kemo+terápiÁ(ban)
részesülő	részesülő
rákbetegeknél	rák+beteg(eknél)
Binocrit	Binocrit
megegyeznek	megegyeznek
korábbi	korábbi
retrospektív	retrospektív
eredményeivel	eredményeivel
megfontolandó	megfontolandó
szildenafilt	szildenafilt
szednek	szednek
mérsékelten	mérsékelten
gátlószerek	gátló+szer(ek)
eritromicin	eritromicin
szakvinavir	szakvinavir
blokkolókat	blokkolókat
érzékenyebbek	érzékenyebbek
fertőzésekre	fertőzésekre
időtartamát	idő+tartam(át)
Rapamune	Rapamune
képzettséggel	képzettséggel
transzplantációs	transzplantációs
szakorvos	szak+orvos
kezdheti	kezdheti
irányításával	irányításával
folytatható	folytatható
Valtropint?	Valtropint?
fogyasztásra	fogyasztásra
termelő	termelő
teheneknek	teheneknek
önkénteseknek	önkénteseknek
dabigatrán	dabigatrán
farmakokinetikai	farmakokinetikai
profilját	profilját
jellemzi	jellemzi
kialakul	kialakul
bevételt	bevételt
meglévő	meglévő
cardiovascularis	cardiovascularis
megbetegedésben	megbetegedésben
szakirodalomban	szak+irodalom(ban)
systolés	systolés
diastolés	diastolés
pulmonalis	pulmonalis
artériás	artériás
vascularis	vascularis
ellenállás	ellenállás
csökkenéséről	csökkenéséről
SPRYCEL-	SPRYCEL-
írhatja	írhatja
leukémia	leukémia
becsült	becsült
eloszlási	eloszlási
térfogat	tér+fogat
diszgeúzia	diszgeúzia
súlyossá	súlyossá
betegtájékoztatóban	beteg+tájékoztató(ban)
mellékhatásokon	mellék+hatás(okon)
tünetet	tünetet
értesítse	értesítse
orvosát	orvosát
gyógyszerészét	gyógyszerészét
hatóanyagával	ható+anyag(ával)
segédanyagával	segéd+anyag(ával)
szembeni	szembeni
Szervrendszerenkénti	szerv+rendszer(enkénti)
csoportosítás	csoportosítás
veseműködés	vese+működés
csúcskoncentrációról	csúcs+koncentráció(ról)
eliminációs	eliminációs
bifázisosan	bifázisosan
üvegpalack	üveg+palack
polipropilén	polipropilén
gyermekbiztonsági	gyermek+biztonság|i
zárókupakkal	zár|ó+kupak(kal)
Revatio	Revatio
foszfodieszteráz-	foszfodieszteráz-
gyógyszercsaládjának	gyógyszer+család(jának)
InductOs-	InductOs-
felhasználást	felhasználást
elkészíteni	elkészíteni
összetevőt	összetevőt
készletből	készletből
Tekintettel	Tekintettel
felvett	felvett
erőteljes	erő+teljes
figyelmeztetésekre	figyelmeztetésekre
ajánlják	ajánlják
ellenőrzését	ellen+őrzés(ét)
egyetértés	egyet+értés
született	született
tekintetben	tekintetben
hipertóniára	hipertóniára
liofilizált	liofilizált
MiniSpike	MiniSpike
rendszert	rend+szer(t)
Prandin	Prandin
Elaprase?	Elaprase?
összetevők	összetevők
erlotinib	erlotinib
valamelyik	valamelyik
oldallánc	oldal+lánc
demetilációja	demetilációja
keletkeznek	keletkeznek
erlotinibéhez	erlotinibéhez
hatásosságot	hatásosságot
mutattak	mutattak
modellekben	modellekben
Mobilat	Mobilat
METALYSE	METALYSE
véletlenül	véletlenül
következményekkel	következményekkel
Boehringer-	Boehringer-
Ausztria	Ausztria
Randomizált	Randomizált
értékelték	értékelték
háromhetente	három+hÉt(ente)
Aranesp-	Aranesp-
vörösvértest-	vörös+vértest-
csökkentésére	csökkentésére
kemoterápiás	kemo+terápiÁ|s
Boehringer	Boehringer
Ingelheim	Ingelheim
Exelon-	Exelon-
közepesen	közepesen
Alzheimer-	Alzheimer-
Rheumocam-	Rheumocam-
keverve	keverve
változhat	változhat
Humalog	Humalog
részesült	részesült
kétszeri	kétszeri
Flexase	Flexase
dialíziskezelésre	dialízis+kezelés(re)
előírásokat	elő+írás(okat)
időnként	időnként
módosítani	módosítani
karbamid	karbamid
kreatinin	kreatinin
káliumszintek	kálium+szint(ek)
tartása	tartása
emellett	emellett
szérumszintek	szérum+szint(ek)
metforminnal	metforminnal
Retacrit	Retacrit
dialíziskezelés	dialízis+kezelés
izoenzimek	izoenzimek
csökkenthetik	csökkenthetik
vardenafil	vardenafil
hatékonysági	hatékonysági
kombinációnak	kombinációnak
kapcsolatosan	kapcsolatosan
bizonyultak	bizonyultak
indokoltnak	indokoltnak
tenofovir-	tenofovir-
dizoproxil-	dizoproxil-
prodrug	prodrug
fumarátsója	fumarát+só(ja)
visszahúzódó	visszahúzódó
alkoholos	alkoholos
törlőkendő	törÖl|ő+kendő
szildenafil	szildenafil
halláscsökkenést	hallás+csökkenés(t)
süketség	süketség
jelentették	jelentették
hozatalt	hozatalt
színűek	színűek
kódjelzéssel	kód+jelzés(sel)
Pegasys	Pegasys
dyspnoea	dyspnoea
bronchoconstrictio	bronchoconstrictio
impotencia	impotencia
angioödéma	angioödéma
többségében	többségében
Firazyr-	Firazyr-
Beszámoltak	Beszámoltak
hallucinációkról	hallucinációkról
hallucináció	hallucináció
antidepresszánsok	anti+depresszáns(ok)
esetleges	esetleges
zárható	zárható
vizelet-	vizelet-
inkontinenecia	inkontinenecia
vizeletretenció	vizeletretenció
"jelöléssel	"jelöléssel
logojával	logojával
atorvastatin	atorvastatin
ARICLAIM	ARICLAIM
hiányoznak	hiányoznak
Oxyglobin	Oxyglobin
ártalmatlanságát	ártalmatlanságát
hatékonyságát	hatékonyságát
thrombocytopeniás	thrombocytopeniás
kutyákban	kutyákban
fennállása	fennállása
oliguria	oliguria
stádiumú	stádiumú
szívbetegség	szív+betegség
Aflunov	Aflunov
világméretű	világ+méret|ű
járványt	járványt
megelőző	megelőző
vakcina	vakcina
emlődaganat	emlő+daganat
Docetaxel	Docetaxel
önmagában	ön+magÁ(ban)
Hagyományos	Hagyományos
karcinogenitási	karcinogenitási
vizsgálatot	vizsgálatot
acetát-	acetát-
dihidráttal	dihidráttal
folytattak	folytattak
ketoacidózist	ketoacidózist
kezelnie	kezelnie
antiretrovirális	antiretrovirális
együttes	együttes
támogató	támogató
gondoljon	gondoljon
számláló	számláló
NEOPHARMA-	NEOPHARMA-
ronthatja	ronthatja
Parkinson-	Parkinson-
tüneteit	tüneteit
bekövetkezik	bekövetkezik
urátkristályok	urát+kristály(ok)
képződnek	képződnek
ízületekben	ízületekben
vesékben	vesékben
gyűjtődoboz	gyűjt|ő+doboz
tartalma	tartalma
leggyakrabban	leggyakrabban
jelentett	jelentett
gastrointestinalis	gastrointestinalis
jellegűek	jellegűek
Tredaptive	Tredaptive
használatához	használatához
mellékhatást	mellék+hatás(t)
betegtájékoztatót	beteg+tájékoztató(t)
szemmel	szemmel
változásokat	változásokat
készítményben	készítményben
BioMarin	BioMarin
Vectibix	Vectibix
antimikrobás	antimikrobás
konzerválószert	konzervál|ó+szer(t)
bakteriosztatikus	bakteriosztatikus
májkárosodásban	máj+károsodás(ban)
Minthogy	Minthogy
alapbetegséggel	alap+betegség(gel)
nagyszámú	nagy+szám|ú
esemény	esemény
jelentkezik	jelentkezik
okozati	okozati
kapcsolat	kapcsolat
razburikáz	razburikáz
Extavia	Extavia
oldószer	old|ó+szer
Telzirrel	Telzirrel
alapvető	alap+vet|ő
fontosságú	fontosságú
ritonavirrel	ritonavirrel
fozamprenavirt	fozamprenavirt
bőrkiütések	bőr+kiütés(ek)
fokozódott	fokozódott
szulfonamid	szulfonamid
allergiája	allergiája
azokhoz	azokhoz
allergiásak	allergiásak
szulfonamidokra	szulfonamidokra
célállat	cél+állat
fajokra	fajokra
embryo/	embryo/
foetalis	foetalis
fejlődési	fejlődési
patkányokban	patkányokban
egerekben	egerekben
szokásos	szokásos
szorosa	szorosa
Optison	Optison
ribavirinnel	ribavirinnel
adagokkal	adagokkal
vizsgálják	vizsgálják
Vékonybél-	vékony+bél+
elzáródás	elzáródás
azoknak	azoknak
húgysavszintje	húgy+sav+szint(je)
Radiogyógyszerészeti	radio+gyógy+szer+(észeti)
prekurzor	prekurzor
Betegeken	Betegeken
Ampullen	Ampullen
Amprenavir	Amprenavir
Indinavir	Indinavir
adagbeállítót	adag+beállító(t)
forgatni	forgatni
MabThera	MabThera
étkezések	étkezések
bevehető	bevehető
abbahagyathatja	abbahagyathatja
topotekánt	topotekánt
szerekkel	szerekkel
kombinálják	kombinálják
gyógyszerkészítmény	gyógy+szer+készítmény
adagját	adagját
esetleg	esetleg
javítása	javítása
szoptasson	szoptasson
Glivec-	Glivec-
szemben	szemben
kórossá	kórossá
megromlott	megromlott
látásról	látásról
megváltozott	megváltozott
látótérről	látó+tér(ről)
üvegtesti	üveg+test|i
vérzésről	vérzésről
retinaleválásról	retina+leválás(ról)
chorioidea	chorioidea
megszűnt	megszűnt
vérellátásáról	vér+ellátás(áról)
kreatinin-	kreatinin-
közepes	közepes
mértékű	mértékű
emelkedéséről	emelkedéséről
hypophosphataemiáról	hypophosphataemiáról
karnitin-	karnitin-
Kinzalkomb	Kinzalkomb
hatóanyagot	ható+anyag(ot)
telmizartánt	telmizartánt
hidroklorotiazidot	hidroklorotiazidot
Revlimid	Revlimid
készülékben	készülékben
üvegfecskendő	üveg+fecskendő
kompatibilitását	kompatibilitását
biztonságosság	biztonságosság
májkárosodást	máj+károsodás(t)
Közölje	Közölje
veseátültetésen	vese+átültetés(en)
veseartéria-	vese+artéria+
szűkületben	szűkület(ben)
szenved	szenved
Olanzapine	Olanzapine
Neopharma-	Neopharma-
Tarceva	Tarceva
vesebetegségben	vese+betegség(ben)
Tárolás	Tárolás
Lokális	Lokális
szemészeti	szemészeti
brinzolamid	brinzolamid
bekerül	bekerül
keringésbe	keringésbe
Viraferon-	Viraferon-
vérnyomáscsökkenés	vérnyomás+csökkenés
elkerülése	elkerülése
megszokottnál	megszokottnál
forgatásával	forgatásával
állítson	állítson
egységet	egységet
Quicklet	Quicklet
Tabletten	Tabletten
CSOMAGOLÁSI	CSOMAGOLÁSI
EGYSÉGEKEN	EGYSÉGEKEN
AMPULLA	AMPULLA
nukleozid-	nukleozid-
függeszteni	függeszteni
tünetekkel	tünetekkel
hyperlactatemia	hyperlactatemia
metabolikus/	metabolikus/
tejsavas	tej+sav(as)
acidosis	acidosis
progresszív	progresszív
hepatomegalia	hepatomegalia
aminotranszferáz-	aminotranszferáz-
Mikrokristályos	mikro+kristály(os)
cellulóz	cellulóz
Povidon	Povidon
Kroszkarmellóz-	Kroszkarmellóz-
Magnézium-	Magnézium-
sztearát	sztearát
methemoglobinszint	methemoglobinszint
következtében	következtében
Addenda	Addenda
Shakespeare	Shakespeare
Gyógyszerek	gyógy+szer(ek)
együttadás	együtt+adás
amprenavir	amprenavir
koncentrációját	koncentrációját
felborítja	felborítja
életben	életben
folyamatokat	folyamatokat
elpusztítja	elpusztítja
baktériumot	baktériumot
ganirelixet	ganirelixet
oldatban	oldatban
Foszfát	Foszfát
kórosak	kórosak
Tracleer-	Tracleer-
felfüggesztése	felfüggesztése
feltárása	feltárása
elvégzése	elvégzése
dönthet	dönthet
szérumszintjének	szérum+szint(jének)
reverzibilis	reverzibilis
fokozódásáról	fokozódásáról
Simulect-	Simulect-
szukcinil-	szukcinil-
porfirinszintézist	porfirinszintézist
aminolevulinsav	aminolevulinsav
felhalmozódásához	felhalmozódásához
betegekéhez	betegekéhez
expozíciós	expozíciós
szinteken	szinteken
jelentkeztek	jelentkeztek
reverzíbilisnek	reverzíbilisnek
mutatkoztak	mutatkoztak
Azoknak	Azoknak
laesióknak	laesióknak
gyógyultnak	gyógyultnak
minősített	minősített
szünteti	szünteti
fertőzést	fertőzést
szervezetükben	szervezetükben
kialakulhatnak	kialakulhatnak
fertőzések	fertőzések
szövődményei	szövődményei
Novartis	Novartis
Sverige	Sverige
Svédország	Svéd+ország
állapították	állapították
hidantoinok	hidantoinok
barbiturátok	barbiturátok
primidon	primidon
karbamazepin	karbamazepin
rifampicin	rifampicin
gyanítható	gyanítható
Ferriprox	Ferriprox
Alkalmanként	Alkalmanként
sebkimetszés	seb+kimetszés
ritkább	ritkább
bőrátültetés	bőr+átültetés
hónapot	hónapot
segédanyagok	segéd+anyag(ok)
listáját	listáját
somnolentia	somnolentia
insomnia	insomnia
nystagmus	nystagmus
meghatározza	meghatározza
Felkészülés	Felkészülés
injekciózásra	injekciózásra
diabéteszes	diabéteszes
szekunder	szekunder
végpontok	vég+pont(ok)
ALKALMAZNI	ALKALMAZNI
NEUPOPEG-	NEUPOPEG-
késleltetett	késleltetett
hypercalcaemia	hypercalcaemia
ZYPREXA	ZYPREXA
dobozonként	dobozonként
emberekre	emberekre
elkerülhetetlen	elkerülhetetlen
betegnek	betegnek
izomrendszer	izom+rendszer
kötőszövet	kötő+szövet
filmtablettát	film+tablettÁ(t)
dobozban	dobozban
patronnal	patronnal
autoinjektor	autoinjektor
Kezelőorvosa	kezel|ő+orvos(a)
Evoltrát	Evoltrát
Tamiflu	Tamiflu
buborékfólia	buborék+fólia
évesnél	évesnél
rendszerint	rendszerint
hatásos	hatásos
titráltak	titráltak
előfordultak	előfordultak
májfunkcióra	máj+funkció(ra)
májenzimek	máj+enzim(ek)
szintjének	szintjének
értékének	értékének
emelkedésével	emelkedésével
információkat	információkat
gyűjteni	gyűjteni
járvány	járvány
biztonságosságáról	biztonságosságáról
hatékonyságáról	hatékonyságáról
értékelésre	értékelésre
benyújtják	benyújtják
Cardiomyopathia	Cardiomyopathia
pericarditis	pericarditis
öninjekciózással	ön+injekciózás(sal)
motivált	motivált
kioktatott	kioktatott
szakértő	szak+ért|ő
segítséget	segítséget
végezhetik	végezhetik
vesebeteg	vese+beteg
Epoetin	Epoetin
megkapja	megkapja
talidomid	talidomid
születési	születési
rendellenességeket	rend+ellenesség(eket)
magzati	magzati
rendellenességet	rend+ellenesség(et)
magzatban	magzatban
rendellenességek	rend+ellenesség(ek)
megrövidülése	megrövidülése
lábfejek	láb+fej(ek)
torzulása	torzulása
rendellenessége	rend+ellenesség(e)
szervekkel	szervekkel
múlásával	múlásával
infúzióval	infúzióval
Élettani	élet+tan|i
vérszintje	vér+szint(je)
sötétedés	sötétedés
beállta	beállta
csúcsértéket	csúcs+érték(et)
éjszaka	éjszaka
közepén	közepén
elősegítve	elősegítve
Couvreur	Couvreur
Rijksweg	Rijksweg
testtája	test+táj(a)
interferonok	interferonok
molekulasúlya	molekula+súly(a)
Oldathoz	Oldathoz
egyadagos	egy+adag(os)
fertőtlenítő	fertőtlenítő
törlőkendőt	törlő+kendő(t)
Kombináció	Kombináció
pioglitazonnal	pioglitazonnal
gliburiddal	gliburiddal
antidiabetikumokkal	antidiabetikumokkal
releváns	releváns
interakciókat	interakciókat
férfiakkal	férfiakkal
nikotinurin-	nikotinurin-
figyelhető	figyelhető
Májkárosodás	máj+károsodás
cirrhosisban	cirrhosisban
paraméterei	paraméterei
módosulnak	módosulnak
gyártási	gyártási
felszabadításáért	felszabadításáért
felelős	felelős
jogosult	jogosult
Laboratory	Laboratory
'Aviation	'Aviation
gondosan	gondosan
monitorozni	monitorozni
Zonegran	Zonegran
szubsztrátok	szubsztrátok
szükségletnek	szükségletnek
memantin	memantin
gátolta	gátolta
enzimeket	enzimeket
tartalmú	tartalmú
monoxigenázt	monoxigenázt
epoxid-	epoxid-
hidrolázt	hidrolázt
szulfatálást	szulfatálást
efavirenzzel	efavirenzzel
abbahagynia	abbahagynia
percnek	percnek
Fogamzóképes	fogamz|ó+képes
Osigraft-	Osigraft-
folytatott	folytatott
tájékoztassák	tájékoztassák
sebészüket	sebészüket
lehetőségéről	lehetőségéről
Gyógyszerforma	gyógyszer+forma
színtelen	színtelen
rekeszre	rekeszre
osztott	osztott
dózistoxicitási	dózistoxicitási
genotoxicitási	genotoxicitási
vizsgálatokból	vizsgálatokból
származó	származó
jellegű	jellegű
igazolták	igazolták
emtricitabin	emtricitabin
veszélyt	veszélyt
EVICEL-	EVICEL-
képzett	képzett
állítaná	állítaná
vérzést	vérzést
második	második
felvitelére	felvitelére
kerülhet	kerülhet
Vizsgálták	Vizsgálták
felszívódásának	felszívódásának
mértékét	mértékét
májműködés	máj+működés
csökkenése	csökkenése
inzulinkezelésre	inzulin+kezelés(re)
glukodinámiás	glukodinámiás
választ	választ
mindegyike	mindegyike
alábbiakat	alábbiakat
tartalmazza	tartalmazza
Szédülés	Szédülés
Perifériás	Perifériás
hypaesthesia	hypaesthesia
ischias	ischias
értékelni	értékelni
fontolni	fontolni
Kombinációs	Kombinációs
morfinnal	morfinnal
placebónál	placebónál
tüneteinek	tüneteinek
szenzitivitás	szenzitivitás
következményeként	következményeként
pioglitazont	pioglitazont
terápiában	terápiában
dózisfügg	dózisfügg
hypoglykaemia	hypoglykaemia
veszélyeztetheti	veszélyeztetheti
szükségessé	szükségessé
magyarázható	magyarázható
mérlegelni	mérlegelni
Zonegran-	Zonegran-
Erbitux	Erbitux
ilyenkor	ilyenkor
állítani	állítani
monoterápiaként	mono+terápia(ként)
kombinált	kombinált
Hepsera	Hepsera
kapcsolódóan	kapcsolódóan
VELCADE-	VELCADE-
vörösvértestek	vörös+vér+test(ek)
fehérvérsejtek	fehér+vér+sejt(ek)
vérlemezke	vér+lemezke
számának	számának
április	április
Dukoral	Dukoral
szakember	szak+ember
tréning	tréning
Aprepitant	Aprepitant
INSUMAN	INSUMAN
Átmeneti	Átmeneti
influenzaszerű	influenzaszerű
tüneteket	tüneteket
Bondenza	Bondenza
jellemzően	jellemzően
beadásakor	beadásakor
előfordul	előfordul
gépjárművezetéskor	gép+jármű+vezetés(kor)
üzemeltetésekor	üzemeltetésekor
éjszakai	éjszakai
vezetéskor	vezetéskor
fényerősség	fény+erősség
változására	változására
számítani	számítani
Irányelvként	irány+elv(ként)
Rebetol-	Rebetol-
kiindulási	kiindulási
fogadhatók	fogadhatók
kórházba	kór+ház(ba)
szakszerű	szak+szer|ű
bőralatti	bőr+alatt|i
hyperhidrosis	hyperhidrosis
INVANZ-	INVANZ-
szoptathatnak	szoptathatnak
kiválasztódik	kiválasztódik
Twinrix	Twinrix
kivédi-	kivédi-
megbetegedést	megbetegedést
ADROVANCE-	ADROVANCE-
szánták	szánták
csillapíthatatlan	csillapíthatatlan
véraláfutása	vér+alá+futás(a)
könnyen	könnyen
sápadtnak	sápadtnak
Cialis-	Cialis-
hozzájárult	hozzá+járul(t)
tudományos	tudományos
adatait	adatait
Tadalafil	Tadalafil
felhasználják	felhasználják
CÍMKESZÖVEG	címke+szöveg
orrspray	orr+spray
nagyobbrészt	nagy+(obb)+rész(t)
fehéres	fehéres
adagjelző	adag+jelző
ablakkal	ablakkal
világoskék	világos+kék
hajtókarral	hajtó+kar(ral)
tömítést	tömítést
kupakkal	kupakkal
műanyag	műanyag
Blepharospasmus	Blepharospasmus
összefüggésben	összefüggésben
tényére	tényére
vizsgálatvezető	vizsgálat+vezető
legalábbis	legalábbis
esetlegesen	esetlegesen
kapcsolatosnak	kapcsolatosnak
tekinti	tekinti
vizsgálatokkal	vizsgálatokkal
óránként	óránként
mennyiségét	mennyiségét
kiszámítani	kiszámítani
emissziók	emissziók
energiái	energiái
szerepelnek	szerepelnek
felsorolásban	felsorolásban
bétarészecske	béta+részecske
energiája	energiája
biomarinno@	biomarinno@
szövetközti	szövet+közti
keresztreaktivitását	kereszt+reaktivitás(át)
szövetből	szövetből
panelhez	panelhez
kötődésének	kötődésének
értékelésével	értékelésével
húgysav-	húgy+sav+
ellenőrzése	ellen+őrzés(e)
glükuronidizációt	glükuronidizációt
erőteljesen	erőteljesen
indukáló	indukáló
bevezetése	bevezetése
testében	testében
depreotid	depreotid
magától	magától
elveszti	elveszti
radioaktivitását	radio+aktivitás(át)
fájdalmat	fájdalmat
duzzanatot	duzzanatot
izületbe	izületbe
Belsőleges	Belsőleges
liofilizátum	liofilizátum
elvégezni	elvégezni
Fevaxyn	Fevaxyn
Pentofelt	Pentofelt
normalizálódás	normalizálódás
reciproka	reciproka
nőgyógyászati	nő+gyógyászat|i
ortopédsebészeti	ortopéd+sebészet|i
coronaria	coronaria
műtétek	műtétek
területén	területén
végezték	végezték
preoperatív	preoperatív
eseteket	eseteket
fogamzásgátlószert	fogamzás+gátló+szer(t)
talidomidot	talidomidot
Posaconazole	Posaconazole
Epivir-	Epivir-
vérmintáiban	vér+mintÁ(iban)
vérvétel	vér+vétel
magasabbnak	magasabbnak
húgysav	húgysav
Farmakodinámiás	Farmakodinámiás
tulajdonságok	tulajdonságok
biztonságosságára	biztonságosságára
engednének	engednének
következtetni	következtetni
naponkénti	naponkénti
bevételével	bevételével
romlásával	romlásával
Ribavirin	Ribavirin
kiszerelésekben	kiszerelésekben
Braille-	Braille-
feltüntetése	feltüntetése
felmentve	felmentve
standard	standard
megszűnnek	megszűnnek
Hypoglykaemia	Hypoglykaemia
jogszabályokkal	jog+szabály(okkal)
összhangban	össz+hang(ban)
klasszikus	klasszikus
sertéspestis	sertés+pestis
felszámolására	felszámolására
Oldószer	old|ó+szer
benzil-	benzil-
benzalkónium-	benzalkónium-
bizonyítására	bizonyítására
végezhető	végezhető
adekvát	adekvát
pótlása	pótlása
kezdődött	kezdődött
antitestek	anti+test(ek)
meggátolják	meggátolják
beépüljön	beépüljön
szervezetben	szervezetben
sejtekbe	sejtekbe
ADENURIC	ADENURIC
emelkedhet	emelkedhet
panaszai	panaszai
súlyosbodhatnak	súlyosbodhatnak
húgysavkristályok	húgy+sav+kristály(ok)
ízületeiben	ízületeiben
veséiben	veséiben
következőkben	következőkben
sorolunk	sorolunk
DULOXETINE	DULOXETINE
BOEHRINGER	BOEHRINGER
INGELHEIM	INGELHEIM
docetaxel-	docetaxel-
körömelváltozások	köröm+elváltozás(ok)
fiatalabbaknál	fiatalabbaknál
Micardisról	Micardisról
gyógyszerre	gyógy+szer(re)
Trocoxil	Trocoxil
adagolását	adagolását
azonnal	azonnal
tanácsot	tanácsot
állatorvostól	állat+orvos(tól)
razagilin	razagilin
irreverzibilis	irreverzibilis
striatumban	striatumban
dopamin	dopamin
extracelluláris	extracelluláris
összetevőjére	összetevőjére
arthritises	arthritises
spondylitis	spondylitis
ankylopoeticában	ankylopoeticában
plakkos	plakkos
psoriasisos	psoriasisos
bőrében	bőrében
patológiás	patológiás
szabályozott	szabályozott
gyulladást	gyulladást
serkentő	serkentő
molekulahálózat	molekula+hálózat
közvetíti	közvetíti
Óvatosan	Óvatosan
pangásos	pangásos
szívelégtelenségben	szív+elégtelenség(ben)
kezelnek	kezelnek
Avastin-	Avastin-
RISPERDAL	RISPERDAL
lenyelnie	lenyelnie
cidofovir	cidofovir
vizsgálni	vizsgálni
vannak-	vannak-
kockázatának	kockázatának
Aclasta	Aclasta
csontok	csontok
kórjának	kórjának
alumínium-	alumínium-
alumínium	alumínium
bliszter	bliszter
csomagot	csomagot
kartondoboz	karton+doboz
bliszterenként	bliszterenként
tablettával	tablettával
abakavir	abakavir
kombinációjának	kombinációjának
karcinogén	karcinogén
potenciálját	potenciálját
Vesekárosodás	Vese+károsodás
vesetranszplantáció	vese+transzplantáció
Karvezidet	Karvezidet
vesefunkciójú	vese+funkció(jú)
húgysavszint	húgy+sav+szint
rendszeres	rendszeres
ivabradin	ivabradin
adagjáról	adagjáról
kimutatták	kimutatták
terheléses	terheléses
paramétereit	paramétereit
hatásosan	hatásosan
eredményeinek	eredményeinek
analízise	analízise
bizonyított	bizonyított
tartóssága	tartóssága
Majmoknál	Majmoknál
változások	változások
hatásával	hatásával
megnyúlásán	megnyúlásán
hemoglobin	hemoglobin
vörösvérsejt	vörös+vér+sejt
hematokrit	hematokrit
reticulocyta	reticulocyta
levetiracetám	levetiracetám
szindrómák	szindrómák
myoclonusos	myoclonusos
görcsrohamokkal	görcs+roham(okkal)
idiopátiás	idiopátiás
generalizált	generalizált
epilepsziában	epilepsziában
Izgatottság	Izgatottság
deperszonalizáció	deperszonalizáció
emocionális	emocionális
labilitás	labilitás
Kenterát?	Kenterát?
ZYPADHERA	ZYPADHERA
egyénen	egyénen
egyének	egyének
eltérésekkel	eltérésekkel
szisztematikus	szisztematikus
tesztet	tesztet
lehetőleg	lehetőleg
Törzskönyvezett	törzs+könyv(ezett)
megnevezés	megnevezés
fehérjekötődést	fehérje+kötődés(t)
mutatták	mutatták
antiviralis	antiviralis
átlagosan	átlagosan
jelenlétében	jelenlétében
cetirizin-	cetirizin-
abbahagyják	abbahagyják
visszanyeri	visszanyeri
hisztamin	hisztamin
reaktivitását	reaktivitását
felfüggesztette	felfüggesztette
írásbeli	írásbeli
eljárást	eljárást
felkérte	felkérte
maradékanyagokra	maradék+anyag(okra)
beterjesztés	beterjesztés
értékelésekor	értékelésekor
vizsgálja	vizsgálja
szeptember	szeptember
véleményt	véleményt
emelhető	emelhető
adhatják	adhatják
fecskendőn	fecskendőn
jelölésig	jelölésig
inhibitorai	inhibitorai
fokozhatják	fokozhatják
darifenacin	darifenacin
biztonságos	biztonságos
ellenjavallt	ellen+javallt
tételek	tételek
Lederle	Lederle
eelőfordulhat	eelőfordulhat
Viagra-	Viagra-
Bristol-	Bristol-
